Wo, Wo, Wo, Wo, Wo, Wo, Wo, Wo, Wo, Wo, Wo, Wo, Wo, Wo, Wo, Wo, Wo, Wo, Wo, Wo, Wo, Wo, Wo, Wo, Wo, Wo, Wo, Wo, Wo, Wo, Wo, Wo, Wo, Wo, Wo, Wo, Wo, Wo, Wo, Wo, Wo, Wo, Wo, Wo, Wo, Wo, Wo, Wo, Wo, Wo, Wo, Wo, Wo, Wo, Wo, Wo, Wo
Wo, Wo, Wo, Wo, Wo, Wo, Wo, Wo, Wo, Wo, Wo, Wo, Wo, Wo, Wo, Wo, Wo, Wo, Wo, Wo, Wo, Wo, Wo, Wo, Wo, Wo, Wo, Wo, Wo, Wo, Wo, Wo, Wo, Wo, Wo, Wo, Wo, Wo, Wo, Wo, Wo, Wo, Wo, Wo, Wo, Wo, Wo, Wo, Wo, Wo, Wo, Wo, Wo, Wo, Wo, Wo, Wo
Wo, Wo, Wo, Wo, Wo, Wo, Wo, Wo, Wo, Wo, Wo, Wo, Wo, Wo, Wo, Wo, Wo, Wo, Wo, Wo, Wo, Wo, Wo, Wo, Wo, Wo, Wo, Wo, Wo, Wo, Wo, Wo, Wo, Wo, Wo, Wo, Wo, Wo, Wo, Wo, Ww, Wo, Wo, Wo, Wo, Wo, Wo, Wo, Wo, Wo, Wo, Wo, Wo, Wo, Wo, Wo, Wo
Wo, Wo, Wo, Wo, Wo, Wo, Wo, Wo, Wo, Wo, Wo, Wo, Wo, Wo, Wo, Wo, Wo, Wo, Wo, Wo, Wo, Wo, Wo, Wo, Wo, Wo, Wo, Wo, Wo, Wo, Wo, Wo, Wo, Wo, Wo, Wo, Ww, Ww, Ww, Ww, Ww, Ww, Ww, Wo, Wo, Wo, Wo, Wo, Wo, Wo, Wo, Wo, Wo, Wo, Wo, Wo, Wo
Wo, Wo, Wo, Wo, Wo, Wo, Wo, Wo, Wo, Wo, Wo, Wo, Wo, Wo, Wo, Wo, Wo, Wo, Wo, Wo, Wo, Wo, Wo, Wo, Wo, Wo, Wo, Wo, Wo, Wo, Wo, Wo, Wo, Wo, Ww, Ww, Ai, Ww, Ai, Ww, Ds, Ww, Ww, Ww, Ww, Wo, Wo, Wo, Wo, Wo, Wo, Wo, Wo, Wo, Wo, Wo, Wo
Wo, Wo, Wo, Wo, Wo, Wo, Wo, Wo, Wo, Wo, Wo, Wo, Wo, Wo, Wo, Wo, Wo, Wo, Wo, Wo, Wo, Wo, Wo, Wo, Wo, Wo, Wo, Wo, Ww, Wo, Ww, Ww, Ww, Ww, Ww, Ww, Aa, Aa, Ds, Aa, Aa, Ds, Ww, Ai, Ww, Ww, Ww, Wo, Wo, Wo, Wo, Wo, Wo, Wo, Wo, Wo, Wo
Wo, Wo, Wo, Wo, Wo, Wo, Wo, Wo, Wo, Wo, Wo, Wo, Wo, Wo, Wo, Wo, Wo, Wo, Wo, Wo, Wo, Wo, Wo, Wo, Wo, Wo, Wo, Wo, Ww, Ww, Ww, Ww, Ai, Ai, Ai, Ds, Aa, Aa, Aa, Aa, Aa, Ai, Ai, Ww, Ai, Ww, Ww, Ww, Wo, Wo, Wo, Wo, Wo, Wo, Wo, Wo, Wo
Wo, Wo, Wo, Wo, Wo, Wo, Wo, Wo, Wo, Wo, Cme, Wo, Ww, Wo, Wo, Wo, Wo, Wo, Wo, Wo, Wo, Wo, Wo, Wo, Wo, Wo, Ww, Ww, Ww, Ww, Ds, Ww, Aa, Aa, Aa, Ds, Re, Aa, Ha, Ha, Aa, Aa, Ai, Ds, Ds, Ai, Ai, Ww, Ww, Wo, Wo, Wo, Wo, Wo, Wo, Wo, Ww
Wo, Wo, Wo, Wo, Wo, Wo, Wo, Wo, Wo, Kme, Cme, Cme, Ww, Ww, Ww, Wo, Wo, Wo, Wo, Wo, Wo, Wo, Ww, Ww, Ww, Ww, Ww, Ww, Ds, Ds, Aa, Aa, Aa, Aa, Re, Aa, Aa, Aa, Aa^Fpa, Ha^Fpa, Aa, Aa, Aa, Ai, Ai, Ai, Ai, Ai, Ai, Ww, Ai, Ww, Ai, Wo, Ww, Wo, Ww
Wo, Wo, Wo, Wo, Wo, Wo, Wo, Wo, Wo, Cme, Ww, Wwr^Bw\, Ww^Vm, Wwr, Ww, Ww^Vm, Ww, Wo, Wo, Wo, Ww, Ww, Ww, Ww, Ww, Ww, Co, Ds, Co, Ds, Gs, Gs, Aa, Aa, Aa, Aa, Re, Gs, Aa^Vca, Aa, Ds, Aa, Aa, Ai, Aa, Ai, Aa, Ai, Ai, Ww, Ww, Ww, Ww, Ai, Ai, Ai, Aa
Wo, Wo, Wo, Wo, Wo, Wo, Wo, Wo, Ww^Vm, Ww^Vm, Wwr, Wwf, Wwf, Ww, Ww, Ww, Ww, Wwr, Ww, Ww, Ww, Ww, Ww, Ww^Bw\, Ds, Ds, Rd, Co, Rd, Co, Gs, Gs, Re, Aa, Aa, Aa, Aa, Gs, Aa, Aa, Ds, Aa, Aa, Aa, Aa, Aa, Ai, Ai, Ww^Vm, Ai, Ai, Aa, Aa, Ai, Aa, Aa, Re
Wo, Wo, Wo, Wo, Wo, Wo, Wo, Wo, Ww, Ww, Ww, Ww, Ww, Ww, Ww, Wwr, 2 Ww, Ww, Ww^Bw\, Ww, Wwf, Ww^Bw\, Ds, Ds, Rd, Rd, Rd^Vo, Rd, Rd, Rd, Re, Aa, Aa, Aa, Aa, Aa^Voa, Aa, Aa, Aa, Aa, Aa, Aa, Aa, Aa, Aa, Aa, Ai, Ai, Ai, Ai, Ai, Aa, Aa, Aa, Aa^Vca, Aa, Aa^Fpa
Wo, Wo, Wo, Wo, Wo, Wo, Wo, Wo, Wo, Ww, Ww, Wwr, Ww, Ww, Wo, Ww, Wo^Bw\, Ww, Ww, Ww^Bw\, Ds, Ds, Rd, Rd, Chr, Rd, Rd, Rd, Rd, Co, Co, Aa, Aa, Aa, Aa, Aa^Fpa, Aa^Fpa, Aa^Fpa, Aa^Fpa, Aa, Aa, Aa, Aa^Fpa, Aa, Aa, Ai, Ai, Ai, Ai, Ai, Aa, Aa, Aa^Fpa, Aa^Fpa, Aa, Aa, Aa
Wo, Wo, Wo, Wo, Wo, Wo, Wo, Wo, Wo, Wo, Wo, Ww^Vm, Wo, Ww, Wo, Ww, Ww, Ww^Bw\, Ds, Ds, Rd, Rd, Rd^Dr, Rd, Ch, Rd, Chr, Rd, Rd, Rd, Co, Co, Gg, Re, Aa^Fpa, Aa^Fpa, Aa, Aa^Fpa, Re, Re, Aa, Aa, Aa, Aa^Fpa, Aa, Aa, Aa, Ai, Ai, Ai, Aa, Aa, Aa^Fpa, Aa^Fpa, Aa, Aa, Aa
Wo, Wo, Wo, Wo, Wo, Wo, Wo, Wo, Wo, Wo, Wo, Wo, Wo, Wo, Wo, Ww, Ww^Bw\, Ds, Rd^Dr, Rd, Rd, Rd, Rd, Chr, 3 Khr, Rd^Dr, Rd, Rd, Rd, Rd, Rd, Gg, Gs, Gs, Re, Aa, Gs, Aa, Aa, Aa, Aa, Aa, Aa, Aa^Vca, Aa, Aa, Aa, Aa, Aa, Aa, Aa, Aa, Aa, Aa, Aa, Aa, Aa^Fpa
Wo, Wo, Wo, Wo, Wo, Wo, Wo, Wo, Wo, Wo, Wo, Wo, Wo, Wo, Ww, Ww, Ds, Ds, Rd, Rd, Rd^Vc, Rd, Chr, Ch, Chr, Chr, Rd^Dr, Re, Rd, Rd, Co, Co, Gg, Re, Re, Re, Gs, Rd^Vo, Aa, Aa, Aa, Aa, Aa, Aa^Fpa, Aa^Fpa, Aa^Fpa, Aa, Aa, Aa, Aa, Aa, Aa, Aa, Aa, Aa, Aa, Aa
Wo, Wo, Wo, Wo, Wo, Wo, Wo, Wo, Wo, Wo, Wo, Wo, Wo, Ww, Ww, Ww, Ds, Rd, Rd, Rd, Rd, Rd, Rd, Rd, Rd^Dr, Rd, Re, Rd, Rd, Rd^Dr, Co, Co^Dr, Gg, Gs, Aa, Aa, Gg, Aa, Aa, Aa, Aa, Aa, Aa, Aa^Fpa, Aa, Aa, Aa, Aa^Fpa, Aa^Fpa, Aa^Fpa, Aa, Aa, Aa, Aa, Aa, Aa, Aa
Wo, Wo, Wo, Wo, Wo, Wo, Wo, Wo, Wo, Wo, Wo, Wo, Wo, Ww, Ww, Ds, Ds, Co, Co, Rd, Co, Rd, Rd, Rd, Rd, Rd, Rd, Re, Rd, Re, Rd, Rd, Rd, Gg, Gg, Aa, Gg, Aa, Gs, Aa, Aa, Aa, Aa, Aa, Aa, Aa, Aa, Aa, Aa, Aa^Fpa, Aa^Fpa, Aa, Aa, Aa, Aa, Aa, Rd
Wo, Wo, Wo, Wo, Wo, Wo, Wo, Wo, Wo, Wo, Wo, Wo, Ww, Ww, Ww, Ds, Ds, Gg, Gg, Co, Gg, Rd^Dr, Rd, Rd, Rd, Rd, Rd^Dr, Co, Rd^Dr, Co, Rd, Rd, Re, Rd, Re, Rd, Rd, Gg, Re, Aa, Aa, Aa, Aa, Aa, Aa, Aa, Rd, Aa, Rd, Aa^Fpa, Aa, Aa, Rd, Aa, Rd, Rd, Rd
Wo, Wo, Wo, Wo, Wo, Wo, Wo, Wo, Wo, Wo, Wo, Wo, Ww, Ww, Wwf, Ds, Ds, Gs, Gs, Gg, Re^Gvs, Re^Gvs, Gg^Vc, Gg, Co, Co, Gg, Gg, Gg, Gg, Gg, Rd, Rd, Rd, Rd, Re, Rd, Re, Rd, Rd, Rd, Aa, Rd, Aa, Aa, Rd, Rd, Aa, Aa, Rd, Rd, Aa, Aa, Rd, Aa, Aa, Rd
Wo, Wo, Wo, Wo, Wo, Wo, Wo, Wo, Wo, Wo, Wo, Wo, Ww, Ww, Ds, Ds, Ds, Gs, Gg, Re^Gvs, Gg^Gvs, Gg^Gvs, Re^Gvs, Gg, Gg, Gg, Aa, Aa, Aa, Aa, Aa, Gg, Aa, Rd, Gg^Vc, Rd, Aa, Rd, Aa, Aa, Aa, Aa, Aa, Rd, Aa, Rd, Aa, Aa, Aa, Aa, Aa, Aa, Aa, Aa, Aa, Aa, Aa
Wo, Wo, Wo, Wo, Wo, Wo, Wo, Wo, Wo, Wo, Wo, Wo, Ww, Ww, Ww, Ds, Ds, Ds, Ds, Gg^Gvs, Gg, Re^Gvs, Gg, Gg, Gg, Gg, Aa, Aa, Gg, Aa, Aa, Re, Re, Gg, Aa, Aa, Gg, Aa, Aa, Aa, Aa, Gg, Aa, Gs, Ai, Aa, Aa, Aa, Ai, Aa, Aa, Aa, Aa, Aa, Aa, Aa, Aa
Wo, Wo, Wo, Wo, Wo, Wo, Wo, Wo, Wo, Wo, Wo, Wo, Ww, Ww, Ww, Ds, Ds, Ds, Ds, Ds, Ds, Ds, Ds, Ds, Gg, Gg, Gg, Gg, Gs, Gg, Gs, Gg, Aa, Aa, Aa, Hh, Ha, Aa, Aa, Gg, Aa, Ai, Ai, Gs, Aa, Aa, Gs, Ai, Aa, Ai, Aa, Aa, Aa, Aa, Aa, Aa, Aa
Wo, Wo, Wo, Wo, Wo, Wo, Wo, Wo, Wo, Wo, Wo, Wo, Wo, Ww, Ww, Ww, Ds, Ds, Ds, Ds, Ww, Ds, Gg, Gs, Ss, Ss, Ss, Ss, Ss, Gs, Ss, Gs, Aa, Aa, Aa, Ha, Ms, Ha, Ha, Aa, Aa, Aa, Aa, Aa, Aa^Fpa, Ai, Aa^Fpa, Aa, Gs^Fp, Aa, Aa, Aa, Aa, Aa, Aa, Aa, Aa
Wo, Wo, Wo, Wo, Wo, Wo, Wo, Wo, Wo, Wo, Wo, Wo, Wo, Wo, Wwr, Ww, Ww, Ds, Ds, Ds, Ss, Ss, Ss, Gg, Gg, Ww, Ww, Ss, Ss, Ww, Ss, Ss, Ai, Aa, Ai, Hh, Ha, Ms, Ha, Ww, Aa, Ww, Ai, Ai, Aa^Fpa, Aa^Fpa, Aa^Fpa, Aa^Fpa, Ai, Aa^Fpa, Ai, Ai, Gs^Vc, Aa, Ai, Ai, Aa
Wo, Wo, Wo, Wo, Wo, Wo, Wo, Wo, Wo, Wo, Wo, Wo, Wo, Wo, Ww, Ww, Ww, Ww^Vm, Ww, Ds, Ds, Ss, Ww, Ww, Ss, Ss, Ww, Ww, Ss, Ss, Ss^Vhs, Ss, Ai, Ai, Ss, Ss, Hh, Ha, Ha, Aa, Ss, Aa, Aa, Ai, Ww, Aa^Fpa, Aa, Aa, Aa, Aa, Ai, Ai, Aa, Aa, Aa, Ai, Ai
Wo, Wo, Wo, Wo, Wo, Wo, Wo, Wo, Wo, Wo, Wo, Wo, Wo, Wo, Wwr, Wwr, Wwr, Ww, Ww, Ww, Ww, Ds, Ww, Ww, Gs, Ww, Ww, Ww, Ss, Ww, Ss, Ww, Ai, Ww, Ww, Ss, Ai, Ai, Ww, Aa^Vht, Aa, Aa, Aa, Aa, Aa, Aa, Aa, Ai, Ha, Ai, Ha, Ha, Ha, Ha, Aa, Ai, Ai
Wo, Wo, Wo, Wo, Wo, Wo, Wo, Wo, Wo, Wo, Wo, Wo, Wo, Wo, Wo, Ww, Wo, Ww, Ww, Ww, Ww, Ww, Ww, Ss, Ss, Ww, Ss, Ww, Ss, Ss, Ss, Ai, Ss, Ha, Ha, Ss, Ai, Ai, Ai, Aa, Aa, Aa, Ai, Aa, Ai, Ss, Ai, Gg, Aa, Ha, Ms, Ms, Ms, Ha, Ha, Ha, Ha
Wo, Wo, Wo, Wo, Wo, Wo, Wo, Wo, Wo, Wo, Wo, Wo, Wo, Wo, Wo, Wo, Wo, Wo, Wo, Ww, Ww, Ww, Ww, Ds, Ww, Ss, Ds, Ss, Ww, Ss, Ww, Ww, Ss, Hh, Ha, Ai, Aa, Ai, Ss, Ai, Aa, Ai, Ai, Aa, Ha, Ai, Ms, Ms, Ha, Ms, Ms, Ha, Ha, Ms, Ms, Ms, Ms
Wo, Wo, Wo, Wo, Wo, Wo, Wo, Wo, Wo, Wo, Wo, Wo, Wo, Wo, Wo, Wo, Wo, Wo, Wo, Ww, Ww, Ww, Ww, Ds, Ss, Ss, Ss, Ww, Ss, Ss, Ss, Ww, Ai, Hh, Ms, Ha, Ha, Ai, Aa, Aa, Aa, Aa, Ss, Ai, Ms, Ms, Ms, Ms, Aa, Ha, Ha, Ms, Ms, Ms, Ha, Ms, Ms
Wo, Wo, Wo, Wo, Wo, Wo, Wo, Wo, Wo, Wo, Wo, Wo, Wo, Wo, Wo, Wo, Wo, Wo, Wo, Wo, Ww, Ww, Ww, Ss^Vm, Ds, Ss, Ss, Ss, Ss, Ss, Ss, Ai, Ai, Aa, Ha, Ha, Ha, Aa, Ai, Ai, Ai, Ha, Ha, Ha, Ms, Ms, Ha, Ha, Ha, Ms, Ms, Ha, Ha, Ha, Ha, Ha, Ha
Wo, Wo, Wo, Wo, Wo, Wo, Wo, Wo, Wo, Wo, Wo, Wo, Wo, Wo, Wo, Wo, Wo, Wo, Wo, Wo, Ww, Ww, Ww, Ss, Ww, Ss, Ss, Ww, Ss, Ss, Ww, Ai, Ai, Aa, Aa, Aa, Ai, Aa, Ai, Aa, Aa, Ha, Ha, Ms, Ha, Ha, Ms, Aa, Ha, Ms, Ms, Ms, Ha, Ha, Ms, Ms, Ha
Wo, Wo, Wo, Wo, Wo, Wo, Wo, Wo, Wo, Wo, Wo, Wo, Wo, Wo, Wo, Wo, Wo, Wo, Wo, Wo, Ww, Ww, Ww, Ww, Ww, Ds, Ww, Ss, Ss, Ss, Ss, Ww, Ai, Aa, Ai, Ai, Ai, Ai, Aa, Aa, Hh, Ha, Ha, Ms, Ha, Hh, Ms, Ms, Hh, Ha, Hh, Ms, Hh, Hh, Ms, Ms, Hh
Wo, Wo, Wo, Wo, Ww, Ww, Wwr, Wo, Wo, Wo, Wo, Wo, Wo, Wo, Wo, Wo, Wo, Wo, Wo, Wo, Wo, Ww, Ww, Ww, Ww, Ww, Ww, Ww, Ww, Ss, Ss, Ww, Ai, Ai, Ai, Ww, Ai, Aa, Aa, Ai, Ww, Ms, Ms, Ms, Hh, Ha, Hh, Ha, Hh, Ms, Ms, Hh, Hh, Hh, Hh, Hh, Hh
Wo, Wo, Wo, Wo, Ww, Wwr, Ww^Vm, Ww, Wo, Wo, Wo, Wo, Wo, Wo, Wo, Wo, Wo, Wo, Wo, Wo, Wo, Ww, Ww, Ww, Ww, Ww, Ww, Ww, Ss, Ww, Ww, Ww, Ss, Ww, Ai, Ss, Ss, Aa, Ss, Ss, Ha, Ms, Ms, Ms, Ss, Hh, Ss, Ss, Ss, Ms, Ms, Ss, Ss, Hh, Ss, Ms, Ss
Wo, Wo, Wo, Wo, Ww, Wwr, Ww, Ww, Wo, Wo, Wo, Wo, Wo, Wo, Wo, Wo, Wo, Wo, Wo, Wo, Wo, Wo, Ww, Ww, Ww, Ww, Ss, Ww, Ss, Ss, Ss^Vhs, Ss, Ww, Ai, Gg, Ss, Ss, Ss, Ss, Hh, Mm, Md, Ss, Ss, Ss, Ss, Ss, Ss, Ss, Ss, Ss, Ss, Ss, Ss^Vhs, Ss, Ss, Ss
Wo, Wo, Wo, Wo, Wo, Ww, Wo, Wo, Wo, Wo, Wo, Wo, Wo, Wo, Wo, Wo, Wo, Wo, Wo, Wo, Ww, Ww, Ww, Ww, Ww, Ww, Ss, Ss, Ss, Ww, Ww, Gg, Ss, Ss, Ss, Ss, Ss, Ss, Ss, Hh, Ww, Mm, Mm, Ss, Hh, Ss, Ss, Ss, Mm^Vhh, Ss, Ss, Ss, Ce, Ce, Ce, Hh, Md
Wo, Wo, Wo, Wo, Wo, Wo, Wo, Wo, Wo, Wo, Wo, Wo, Wo, Wo, Wo, Wo, Wo, Wo, Wo, Wo, Ww, Ww, Ww, Ww, Ww, Ww, Ww, Ss, Ss, Ss, Ss, Ss, Ss, Ss, Ss, Ww, Gg, Ss, Ss, Hh, Hh, Md, Hh, Mm, Hh, Ss, Ss, Ss, Ss, Ss, Ss, Ce, Ce, 1 Ke, Md, Md, Md
Wo, Wo, Wo, Wo, Wo, Wo, Wo, Wo, Wo, Wo, Wo, Wo, Wo, Wo, Wo, Wo, Wo, Wo, Ww, Ww, Ww, Ww, Ss, Ss, Ss, Ss, Ss, Ss, Ww, Ww, Ss, Ss, Ww, Ss, Ss, Gg, Ss, Ss, Ss, Ss, Hh, Md, Md, Mm, Hh, Hh, Hh, Ss, Ss, Ss^Vhs, Ss, Hh, Hh, Md, Md, Md, Md
Wo, Wo, Wo, Wo, Wo, Wo, Wo, Wo, Wo, Wo, Wo, Wo, Wo, Wo, Wo, Wo, Wo, Wo, Ww, Ww, Ss, Ss, Ss, Ww, Ss, Ss, Ww, Ss, Ss, Ss, Ss, Ss, Ss, Ss, Ss, Ss, Ss, Ss, Ss, Ss, Ss, Hh, Md, Md, Mm, Hh, Ss, Ss, Hh, Ss, Ss, Ss, Hh, Hh, Md, Md, Md
