Wwg, Wog, Wog, Wog, Wog, Wog, Wog, Wog, Wog, Wog, Wog, Wog, Wog, Wwg, Wog, Wog, Wog, Wog, Wwg, Wog, Wog, Wog, Wog, Wwg, Wog, Wog, Wwg, Wwg, Wog, Wog, Wwg, Wwg, Wog, Wog, Wwg, Wog, Wwg, Wwg, Wog, Wwg, Wog, Wog, Wwg, Wwg, Wwg
Wog, Wog, Wog, Wog, Wwg, Wwg, Wwg, Wog, Wwg, Wwg, Wog, Wog, Wwg, Wwg, Wog, Wog, Wwg, Wwg, Wog, Wwg, Wog, Wog, Wwg, Wwg, Wog, Wog, Wwg, Wog, Wog, Wwg, Wog, Wog, Wwg, Wwg, Wog, Wog, Wog, Wog, Wog, Wog, Wog, Wog, Wog, Wog, Wog
Wog, Wog, Wog, Wog, Wwg, Wog, Wog, Wog, Wwg, Wog, Wog, Wog, Wwg, Wog, Wwg, Wwg, Wog, Wog, Wwg, Wog, Wog, Wwg, Wog, Wog, Wwg, Wwg, Cme, Wog, Cme, Wog, Wog, Wog, Wog, Wog, Wog, Wog, Wog, Wog, Wog, Wog, Wog, Wog, Wog, Wog, Wog
Wog, Wog, Wwg, Wwg, Wog, Wog, Wwg, Wwg, Wwg, Wog, Wwg, Wwg, Wog, Wog, Wwg, Wog, Wog, Wwg, Wog, Wog, Wog, Wwg, Wog, Wog, Wog, Wog, Cme, 1 Kme, Cme, Cme, Wog, Wog, Wog, Wog, Wwg, Wog, Wog, Wog, Wwg, Wog, Wog, Wog, Wwg, Wog, Wog
Wog, Wog, Wwg, Wog, Wog, Wwg, Wog, Wog, Wog, Wog, Wog, Wog, Wog, Wog, Wog, Wog, Wog, Wog, Wog, Wog, Wog, Wog, Wog, Wog, Wog, Wog, Wog, Cme, Wwg, Wwg, Wog, Wog, Wwg, Wwg, Wog, Wwg, Wog, Wwg, Wog, Wog, Wog, Wwg, Wog, Wog, Wog
Wog, Wwg, Wog, Wog, Wwg, Wwg, Wog, Wog, Wog, Wog, Wog, Wog, Wog, Wog, Wog, Wog, Wwg, Wog, Wog, Wwg, Wog, Wog, Wwg, Wog, Wwg, Wog, Wog, Wog, Wwg, Wog, Wwg, Wwg, Wog, Wog, Wog, Wog, Wwg, Wwg, Wog, Wog, Wwg, Wwg, Wog, Wog, Wwg
Wwg, Wwg, Wog, Wog, Wog, Wog, Wog, Wog, Wog, Wog, Wog, Wog, Wwg, Wog, Wog, Wwg, Wog, Wog, Wwg, Wwg, Wog, Wwg, Wog, Wwg, Wog, Wog, Wog, Wwg, Wog, Wog, Wwg, Wog, Wog, Wog, Wwg, Wwg, Wog, Wwg, Wog, Wwg, Wog, Wog, Wwg, Wwg, Wog
Wwg, Wog, Wog, Wog, Wog, Wog, Wog, Wog, Wog, Wog, Wog, Wwg, Wog, Wog, Wwg, Wwg, Wog, Wwg, Wog, Wog, Wog, Wwg, Wwg, Wog, Wog, Wog, Wwg, Wwg, Wog, Wog, Wwg, Wog, Wog, Wog, Wwg, Wog, Wog, Wog, Wwg, Wwg, Wog, Wog, Wwg, Wog, Wog
Wog, Wog, Wog, Wog, Wog, Wog, Wwg, Wwg, Wog, Wog, Wwg, Wwg, Wog, Wog, Wwg, Wog, Wog, Wwg, Wog, Wog, Wwg, Wwg, Wog, Wog, Wwg, Wwg, Wog, Wog, Wwrg, Wwg, Wog, Wog, Wwg, Wwg, Wog, Wog, Wwg, Wwg, Wog, Wog, Wwg, Wwg, Wog, Wog, Wwg
Wog, Wog, Wog, Wog, Wog, Wog, Wwg, Wog, Wog, Wog, Wwg, Wog, Wog, Wog, Wwg, Wog, Wog, Wwg, Wog, Wog, Wwg, Wog, Wog, Wog, Wwg, Wog, Wog, Wog, Wog, Wog, Wog, Wwg, Wog, Wog, Wog, Wwg, Wwg, Wog, Wog, Wog, Wwg, Wog, Wog, Wwg, Wog
Wog, Wog, Wwg, Wwg, Wog, Wog, Wwg, Wog, Wog, Wwg, Wog, Wog, Wog, Wwg, Wog, Wog, Wwg, Wwg, Wog, Wwg, Wog, Wog, Wog, Wog, Wog, Wog, Wog, Wog, Wog, Wog, Wog, Wog, Wog, Wog, Wog, Wog, Wog, Wog, Wog, Wog, Wog, Wog, Wog, Wwg, Wog
Wog, Wog, Wwg, Wog, Wwg, Wwg, Wog, Wog, Wwrg, Wwg, Wog, Wog, Wwg, Wwg, Wog, Wwg, Wog, Wog, Wog, Wwg, Wog, Wog, Wog, Wog, Wog, Wog, Wog, Wog, Wog, Wog, Wog, Wog, Wog, Wog, Wog, Wog, Wog, Wog, Wog, Wog, Wog, Wog, Wog, Wog, Wog
Wog, Wwg, Wog, Wog, Wwg, Wog, Wog, Wwg, Wog, Wog, Wwg, Wwg, Wog, Wog, Wog, Wwg, Wog, Wog, Wog, Wog, Wog, Wog, Wog, Wog, Wog, Wog, Wog, Wog, Wog, Wog, Wog, Wog, Wog, Wog, Wwg, Wog, Wog, Wog, Wog, Wog, Wog, Wog, Wog, Wog, Wog
Wog, Wwg, Wog, Wog, Wwg, Wog, Wog, Wwg, Wog, Wog, Wwg, Wog, Wog, Wog, Wog, Wog, Wog, Wog, Wog, Wog, Wwg, Wwg^Vm, Wwg, Wog, Wwg, Wwg, Wog, Wog, Wwg, Wwg, Wwg, Wog, Wwg, Wwrg, Wog, Wwg, Wog, Wwg, Wwg, Wwg, Wwg, Wog, Wog, Wog, Wog
Wog, Wwg, Wog, Wog, Wwg, Wog, Wog, Wwg, Wog, Wog, Wog, Wog, Wog, Wog, Wog, Wog, Wwg, Wog, Wog, Wwg, Wog, Wog, Wog, Wog, Wwg, Wog, Wwg, Wwg, Wog, Wog, Wog, Wog, Wwg, Wog, Wog, Wog, Wwg, Wwg, Wog, Wog, Wog, Wog, Wwg, Wwg, Wwg
Wog, Wwg, Wwg, Wog, Wog, Wwg, Wog, Wog, Wog, Wog, Wog, Wog, Wog, Wog, Wwg, Wwg, Wog, Wwg, Wog, Wwg, Wog, Wog, Wwg, Wwg, Wog, Wog, Wwg, Wog, Wog, Wog, Wwrg, Wog, Wwg, Wog, Wog, Wog, Wwg, Wog, Wog, Wog, Wwg, Wwg, Wog, Wog, Wwg
Wwg, Wog, Wog, Wwg, Wog, Wwg, Wog, Wog, Wog, Wog, Wog, Wog, Wwg, Wog, Wwg, Wog, Wog, Wog, Wwg, Wwg, Wog, Wwg, Wog, Wog, Wog, Wog, Wwg, Wog, Wwg, Wwg, Wog, Wwg, Wog, Wog, Wwg, Wwg, Wog, Wog, Wwg, Wog, Wwg, Wog, Wog, Wog, Wog
Wwg, Wog, Wog, Wwg, Wwg, Wog, Wog, Wog, Wog, Wog, Wog, Wwg, Wog, Wog, Wwg, Wog, Wog, Wwg, Wog, Wog, Wwg, Wwrg, Wog, Wog, Wwg, Wwg, Wog, Wog, Wog, Wog, Wog, Wog, Wog, Wog, Wog, Wog, Wog, Wwg, Wog, Wwg, Wog, Wog, Wwg, Wwg, Wwg
Wog, Wwrg, Wwg, Wog, Wog, Wog, Wog, Wog, Wog, Wog, Wog, Wwg, Wwg, Wog, Wog, Wwrg, Wog, Wwg, Wwg, Wog, Wog, Wog, Wog, Wog, Wog, Wog, Wog, Wog, Wog, Wog, Wog, Wog, Wog, Wog, Wog, Wog, Wog, Wog, Wog, Wog, Wog, Wog, Wog, Wog, Wog
Wog, Wog, Wwg, Wog, Wog, Wog, Wog, Wog, Wog, Wog, Wwg, Wog, Wwg, Wog, Wog, Wwg, Wog, Wog, Wog, Wog, Wog, Wog, Wog, Wog, Wog, Wog, Wog, Wog, Wog, Wog, Wwg, Wwg, Wog, Wog, Wwg, Wwg, Wwg, Wog, Wog, Wog, Wog, Wog, Wog, Wog, Wog
Wwg, Wog, Wog, Wog, Wog, Wog, Wog, Wog, Wog, Wog, Wwg, Wog, Wog, Wwg, Wog, Wwg, Wog, Wog, Wog, Wog, Wog, Wog, Wog, Wog, Wwg, Wog, Wwg, Wwg, Wog, Wog, Wwrg, Wog, Wog, Wwg, Wog, Wog, Wog, Wog, Wwg, Wog, Wog, Wog, Wog, Wog, Wog
Wwg, Wog, Wog, Wog, Wog, Wog, Wog, Wog, Wog, Wwg, Wog, Wog, Wog, Wwg, Wog, Wwg, Wog, Wwg^Vm, Wog, Wog, Wwg, Wwg, Wwg, Wwg, Wog, Wog, Wwg, Wog, Wog, Wwg, Wog, Wog, Wog, Wwg, Wog, Wwg^Vm, Wwg, Wwg, Wog, Wwg, Wog, Wog, Wog, Wog, Wog
Wog, Wwg, Wog, Wog, Wog, Wog, Wog, Wog, Wog, Wwg, Wwg, Wog, Wog, Wwg, Wwg, Wog, Wog, Wog, Wog, Wog, Wwg, Wog, Wog, Wog, Wwrg, Wwg, Wog, Wog, Wwg, Wwg, Wog, Wog, Wwg, Wwg, Wog, Wwg, Wog, Wog, Wog, Wog, Wwrg, Wog, Wwg, Wog, Wog
Wog, Wwg, Wog, Wog, Wog, Wog, Wog, Wog, Wwg, Wog, Wog, Wwg, Wog, Wog, Wog, Wog, Wog, Wog, Wog, Wog, Wwg, Wog, Wwg, Wwg, Wog, Wog, Wwg, Wwg, Wog, Wog, Wog, Wwg, Wog, Wog, Wwg, Wwg, Wog, Wog, Wwg, Wwg, Wog, Wwg, Wog, Wwg, Wog
Wwg, Wog, Wog, Wog, Wog, Wog, Wog, Wog, Wwrg, Wwg, Wog, Wwg, Wwg, Wog, Wog, Wog, Wog, Wog, Wwg, Wwg, Wog, Wog, Wwg, Wog, Wog, Wog, Wog, Wog, Wo, Wog, Wog, Wog, Wog, Wog, Wog, Wog, Wwg, Wwg, Wog, Wog, Wog, Wog, Wog, Wwg, Wog
Wog, Wog, Wog, Wog, Wog, Wog, Wwg, Wog, Wwg, Wog, Wog, Wog, Wwg, Wog, Wog, Wog, Wog, Wog, Wwg, Wog, Wog, Wwg, Wo, Wo, Wo, Wo, Wo, Wo, Wo, Wo, Wo, Wo, Wo, Wo, Wo, Wog, Wog, Wog, Wwg, Wog, Wwg, Wwg, Wwg, Wog, Wog
Wog, Wog, Wog, Wog, Wog, Wog, Wwg, Wog, Wog, Wwg, Wwg, Wog, Wog, Wwg, Wog, Wog, Wog, Wog, Wo, Wog, Wo, Wo, Wo, Wo, Wo, Wo, Wo, Wo, Wo, Wo, Wo, Wo, Wo, Wo, Wo, Wog, Wog, Wog, Wog, Wwg, Wog, Wog, Wog, Wwg, Wog
Wwg, Wog, Wog, Wog, Wog, Wog, Wog, Wwg, Wog, Wog, Wwg, Wog, Wog, Wog, Wog, Wog, Wo, Wo, Wo, Wo, Wo, Wo, Qxu, Wo, Qxu, Qxu, Qxu, Qxu, Qxu, Qxu, Qxu, Wo, Qxu, Wo, Wo, Wo, Wog, Wog, Wwg, Wog, Wwg, Wog, Wog, Wwg, Wog
Wwg, Wog, Wog, Wog, Wog, Wog, Wog, Wwg, Wwg, Wog, Wog, Wwg, Wwg, Wog, Wog, Wo, Wo, Wo, Wo, Wo, Wo, Qxu, Qxu, Qxu, Qxu, Qxu, Qxu, Qxu, Qxu, Qxu, Qxu, Qxu, Qxu, Wo, Wo, Wo, Wo, Wog, Wog, Wwrg, Wog, Wwg, Wwg, Wog, Wog
Wog, Wwrg, Wog, Wog, Wog, Wog, Wog, Wog, Wwg, Wog, Wwg, Wog, Wog, Wog, Wog, Wo, Ww^Vm, Wo, Qxu, Wo, Wo, Wo, Wo, Qxu, Qxu, Qxu, Qxu, Qxu, Qxu, Qxu, Qxu, Qxu, Wo, Wo, Wo, Wo, Wo, Wog, Wog, Wog, Wwg, Wog, Wog, Wwg, Wog
Wog, Wog, Wog, Wog, Wog, Wwg, Wwg, Wog, Wog, Wwg, Wog, Wwg, Wog, Wog, Wo, Wo, Wo, Wo, Qxu, Qxu, Qxu, Wo, Wo, Wo, Wo, Qxu, Qxu, Qxu, Qxu, Qxu, Wo, Wo, Wo, Wo, Qxu, Wo, Wo, Wo, Wog, Wog, Wog, Wwg, Wwg, Wog, Wog
Wog, Wog, Wog, Wog, Wog, Wog, Wwg, Wog, Wog, Wog, Wog, Wwg, Wwg, Wog, Wo, Wo, Wo, Wo, Qxu, Qxu, Qxu, Qxu, Qxu, Wo, Wo, Wo, Cm, Ww^Vm, Wo, Wo, Wo, Wo, Qxu, Qxu, Qxu, Wo, Wo, Wo, Wog, Wwg, Wwg, Wog, Wog, Wwg, Wog
Wog, Wog, Wog, Wog, Wwg, Wog, Wog, Wwg, Wwg, Wwg, Wwg, Wog, Wog, Wog, Wo, Wo, Wo, Qxu, Qxu, Qxu, Qxu, Qxu, Qxu, Qxu, Cm, Cm, 2 Km, Cm, Cm, Wo, Qxu, Qxu, Qxu, Qxu, Qxu, Qxu, Wo, Wo, Wo, Wog, Wog, Wwg, Wwg, Wog, Wog
Wog, Wog, Wog, Wog, Wog, Wwrg, Wog, Wog, Wog, Wog, Wog, Wwg, Wog, Wo, Wo, Wo, Wo, Qxu, Qxu, Qxu, Qxu, Qxu, Qxu, Ww^Vm, Qxu, Cm, Cm, Cm, Ww^Vm, Qxu, Qxu, Qxu, Qxu, Qxu, Qxu, Wo, Wo, Wo, Wo, Wog, Wwg, Wog, Wog, Wwg, Wog
Wog, Wog, Wog, Wog, Wog, Wwg, Wog, Wog, Wwg, Wwg, Wog, Wwg, Wwg, Wog, Wo, Wo, Wo, Wo, Wo, Qxu, Qxu, Qxu, Qxu, Qxu, Qxu, Wo, Wo, Qxu, Qxu, Qxu, Qxu, Qxu, Qxu, Qxu, Qxu, Wo, Wo, Wo, Wog, Wog, Wwg, Wog, Wog, Wwg, Wog
Wwg, Wog, Wog, Wog, Wog, Wwg, Wwg, Wog, Wog, Wwg, Wwg, Wog, Wog, Wog, Wog, Wo, Wo, Wo, Wo, Qxu, Qxu, Qxu, Qxu, Qxu, Qxu, Wo, Wo, Qxu, Qxu, Qxu, Qxu, Qxu, Qxu, Qxu, Qxu, Wo, Wo, Wo, Wwg, Wog, Wog, Wwg, Wwg, Wog, Wog
Wwg, Wog, Wog, Wog, Wog, Wog, Wog, Wwg, Wwg, Wog, Wog, Wwg, Wwg, Wog, Wwg, Wog, Wo, Wo, Wo, Qxu, Qxu, Qxu, Qxu, Qxu, Qxu, Wo, Wo, Qxu, Qxu, Qxu, Qxu, Qxu, Qxu, Qxu, Wo, Wo, Wo, Wo, Wog, Wwg, Wwg, Wog, Wog, Wwg, Wog
Wog, Wog, Wog, Wog, Wog, Wog, Wog, Wog, Wog, Wwg, Wog, Wog, Wog, Wwg, Wog, Wog, Wog, Wo, Wo, Wo, Wo, Wo, Wo, Qxu, Qxu, Wo, Wo, Qxu, Qxu, Qxu, Qxu, Qxu, Qxu, Wo, Wo, Wo, Wog, Wwg, Wwg, Wog, Wog, Wwg, Wog, Wwg, Wog
Wog, Wog, Wog, Wog, Wog, Wog, Wog, Wwg, Wwg, Wog, Wwg, Wwg, Wwg, Wog, Wwg, Wog, Wwg, Wog, Wog, Wo, Wo, Wo, Wo, Wo, Wo, Wo, Wo, Wo, Wo, Wo, Wo, Wo, Wo, Wo, Wo, Wo, Wwg, Wog, Wog, Wwg, Wog, Wwg, Wwg, Wog, Wog
Wwg, Wwg, Wog, Wog, Wog, Wog, Wog, Wog, Wog, Wwg, Wog, Wog, Wog, Wwg, Wog, Wwg, Wog, Wog, Wog, Wog, Wog, Wog, Wog, Wo, Wo, Wo, Wo, Wo, Wo, Wo, Wo, Wo, Wo, Ww^Vm, Wog, Wog, Wwg, Wog, Wog, Wwg, Wwrg, Wog, Wwg, Wog, Wog
Wog, Wog, Wog, Wog, Wog, Wog, Wog, Wwg, Wwg, Wog, Wwg, Wog, Wog, Wog, Wwg, Wog, Wwrg, Wwg, Wwg, Wwg, Wog, Wog, Wog, Wog, Wog, Wog, Wog, Wog, Wog, Wog, Wog, Wog, Wog, Wog, Wwg, Wwg, Wog, Wog, Wog, Wog, Wwg, Wog, Wog, Wog, Wog
Wwg, Wog, Wwg, Wog, Wog, Wog, Wog, Wog, Wog, Wwg, Wog, Wwg, Wwg, Wog, Wog, Wwg, Wog, Wog, Wog, Wog, Wwg, Wwg, Wog, Wog, Wog, Wog, Wwg, Wwg, Wog, Wog, Wwg, Wog, Wog, Wog, Wwg, Wog, Wog, Wwg, Wog, Wog, Wog, Wog, Wog, Wog, Wog
