border_size=1
usage=map


Gg          , Gg          , Gg          , Gg          , Gg          , Gg          , Gg          , Rb^Gvs      , Rb^Gvs      , Rb^Gvs      , Rb^Gvs      , Gg          , Gg          , Gg          , Gg          , Hh          , Hh          , Hh          , Hh          , Hh          , Gg          , Gg          , Re          , Re          , Re          , Gg          , Gg          , Gg          , Gg          , Gg          , Rb^Gvs      , Rb^Gvs      , Rb^Gvs      , Rb^Gvs      , Rb^Gvs      , Rb^Gvs      , Gg          , Hh          , Hh          , Hh          , Hh          , Gg          , Gg          , Gg          , Gg          , Gg          
Rb^Gvs      , Rb^Gvs      , Rb^Gvs      , Gg          , Hh          , Hh          , Hh          , Gg          , Rb^Gvs      , Rb^Gvs      , Rb^Gvs      , Rb^Gvs      , Gg          , Gg          , Gg          , Gg          , Gg          , Gg          , Gg          , Gg          , Gg          , Gg          , Re          , Re          , Re          , Gg          , Gg          , Gg          , Gg          , Gg          , Rb^Gvs      , Rb^Gvs      , Gs^Vh       , Rb^Gvs      , Rb^Gvs      , Rb^Gvs      , Gg          , Hh          , Hh          , Hh          , Hh          , Gg          , Rb^Gvs      , Rb^Gvs      , Rb^Gvs      , Gg          
Rb^Gvs      , Rb^Gvs      , Rb^Gvs      , Gg          , Hh          , Hh          , Gg          , Gg          , Rb^Gvs      , Rb^Gvs      , Rb^Gvs      , Rb^Gvs      , Gg          , Gg          , Gg          , Gg          , Gg          , Gg          , Ww          , Ww          , Ww          , Ww          , Ww^Bsb|     , Ww          , Ww^Bsb|     , Ww          , Ww          , Ww          , Ww          , Gg          , Gg          , Gg          , Gg          , Rb^Gvs      , Rb^Gvs      , Rb^Gvs      , Gg          , Gg          , Gg          , Gg          , Gg          , Gg          , Rb^Gvs      , Rb^Gvs      , Rb^Gvs      , Gg          
Gg          , Gg          , Gg          , Gg          , Gg          , Hh          , Rb^Gvs      , Rb^Gvs      , Gs^Vh       , Rb^Gvs      , Gg          , Gg          , Gg          , Gg          , Ww          , Ww          , Ww          , Ww          , Wo          , Wo          , Wo          , Wo          , Wo^Bsb|     , Wo          , Wo^Bsb|     , Wo          , Wo          , Wo          , Wo          , Ww          , Ww          , Gg          , Gg          , Gg          , Gg          , Gg          , Gg          , Gg          , Rb^Gvs      , Rb^Gvs      , Rb^Gvs      , Rb^Gvs      , Rb^Gvs      , Rb^Gvs      , Gg          , Gg          
Re          , Gg          , Gg          , Gg          , Rb^Gvs      , Rb^Gvs      , Rb^Gvs      , Rb^Gvs      , Rb^Gvs      , Gg          , Gg          , Gg          , Ww          , Ww          , Wo          , Wo          , Wo          , Wo          , Ww          , Ww          , Ww          , Ww          , Ww^Bsb|     , Ww          , Ww^Bsb|     , Ww          , Ww          , Ww          , Ww          , Wo          , Wo          , Ww          , Ww          , Ww          , Ww          , Gg          , Ww          , Gg          , Gg          , Rb^Gvs      , Gs^Vh       , Rb^Gvs      , Rb^Gvs      , Rb^Gvs      , Gg          , Gg          
Re          , Re          , Re          , Gg          , Gg          , Rb^Gvs      , Gg          , Rb^Gvs      , Gg          , Gg          , Ww          , Ww          , Ww          , Wo          , Ww          , Wo          , Ww          , Ww          , Gg          , Ch          , Gg          , Ch          , Rr          , Rr          , Rr          , Ch          , Gg          , Ch          , Gg          , Ww          , Ww          , Wo          , Wo          , Wo          , Wo          , Ww          , Ww          , Ww          , Ww          , Gg          , Gg          , Rb^Gvs      , Gg          , Gg          , Re          , Re          
Re          , Re          , Re          , Re          , Re          , Gg          , Gg          , Gg          , Gg          , Gg          , Ww          , Ww          , Wo          , Wo          , Ww          , Ww          , Gg          , Ch          , Gg          , Gg          , Gg^Fds      , Gg          , Rr          , Rr          , Rr          , Gg          , Gg          , Gg^Fds      , Gg          , Ch          , Gg          , Ww          , Ww          , Ww          , Wo          , Wo          , Wo          , Ww          , Ww          , Ww          , Ww          , Gg          , Re          , Re          , Re          , Re          
Gg          , Re          , Re          , Re          , Re          , Re          , Re          , Gg          , Ww          , Ww          , Wo          , Wo          , Ww          , Ww          , Gg          , Ch          , Re          , Re          , Re          , Gs^Vh       , Re          , Gg          , Rr          , Rr          , Rr          , Gg          , Re          , Gs^Vh       , Re          , Re          , Re          , Ch          , Gg          , Ww          , Ww          , Wo          , Ww          , Wo          , Wo          , Ww          , Ww^Bsb/     , Ww^Bsb/     , Re          , Re          , Re          , Re          
Gg          , Gg          , Gg          , Re          , Re          , Re          , Re          , Re          , Ww^Bsb\     , Ww          , Wo          , Ww          , Gg          , Ch          , Re          , Re          , Re          , Re          , Re          , Re          , Re          , Re          , Rr          , Rr          , Rr          , Re          , Re          , Re          , Re          , Re          , Re          , Re          , Re          , Ch          , Gg          , Ww          , Ww          , Ww          , Ww^Bsb/     , Wo^Bsb/     , Wo          , Ww          , Ww^Bsb/     , Re          , Gg          , Gg          
Rb^Gvs      , Rb^Gvs      , Rb^Gvs      , Gg          , Gg          , Re          , Ww^Bsb\     , Ww          , Wo          , Wo^Bsb\     , Ww^Bsb\     , Ww          , Ch          , Gs^Vh       , Re          , Re          , Gs^Vh       , Gs^Vh       , Gg          , Re          , Gg          , Re          , Rr          , Rr          , Rr          , Re          , Gg          , Re          , Gg          , Gs^Vh       , Gs^Vh       , Re          , Re          , Re          , Gg          , Ch          , Rr          , Ww^Bsb/     , Ww          , Wo          , Wo^Bsb/     , Ww^Bsb/     , Ww          , Gg          , Gg          , Hh          
Rb^Gvs      , Rb^Gvs      , Gs^Vh       , Rb^Gvs      , Gg          , Gg          , Ww          , Ww^Bsb\     , Wo^Bsb\     , Ww          , Rr          , Rr          , Gg          , Gg^Fds      , Re          , Re          , Gg          , Gg          , Ce          , Ce          , Gg          , Gg          , Rr          , Rr          , Rr          , Gg          , Gg          , Ce          , Ce          , Gg          , Gg          , Gs^Vh       , Re          , Re          , Gs^Vh       , Gg^Fds      , Rr          , Rr          , Ww^Bsb/     , Ww^Bsb/     , Wo          , Wo          , Ww          , Gg          , Gg          , Hh          
Rb^Gvs      , Rb^Gvs      , Rb^Gvs      , Gg          , Ww          , Ww          , Wo          , Wo          , Ww          , Ww^Bsb\     , Rr          , Rr          , Rr          , Gg          , Re          , Re          , Gg          , Ce          , Gg          , Gg          , Rr^Vhc      , Gg          , Rr          , Rr          , Rr          , Gg          , Rr^Vhc      , Gg          , Gg          , Ce          , Gg          , Gg          , Re          , Re          , Rr          , Rr          , Gg          , Rr          , Ww          , Ww          , Wo          , Wo          , Ww          , Ww          , Gg          , Gg          
Gg          , Rb^Gvs      , Gg          , Gg          , Ww          , Wo          , Ww          , Ww          , Gg          , Ch          , Gg          , Gg          , Gg          , Rr          , Rr          , Re          , Gg          , Gg          , Rr^Vhc      , Rr^Vhc      , Gg          , Gg          , Ww^Bsb|     , Rr          , Ww^Bsb|     , Gg          , Gg          , Rr^Vhc      , Rr^Vhc      , Gg          , Gg          , Gg          , Rr          , Rr          , Re          , Gg          , Gg          , Gg          , Ch          , Ww          , Ww          , Wo          , Ww          , Ww          , Gg          , Gg          
Gg          , Gg          , Gg          , Gg          , Ww          , Wo          , Ww          , Ch          , Gg          , Gg          , Gs^Fds      , Gg          , Gg          , Re          , Re          , Rr          , Rr          , Gg          , Gg          , Gg          , Ww          , Ww          , Rr          , Ww          , Rr          , Ww          , Ww          , Gg          , Gg          , Gg          , Rr          , Rr          , Gg          , Re          , Re          , Gg          , Gg          , Gg          , Gg          , Ww          , Ww          , Wo          , Wo          , Ww          , Gg          , Rb^Gvs      
Hh          , Gg          , Gg          , Ww          , Ww          , Wo          , Ww          , Gg          , Gg          , Gs^Fds      , Gs^Fds      , Gg          , Gs^Vh       , Re          , Re          , Gg          , Gg          , Rr          , Ww^Bsb\     , Ww          , Rrc^Vhc     , Rrc^Vhc     , Rrc         , Rr          , Rrc         , Rrc^Vhc     , Rrc^Vhc     , Ww          , Ww^Bsb/     , Rr          , Gg          , Gg          , Gg          , Re          , Re          , Gs^Vh       , Gg          , Gg          , Gg          , Ch          , Ww          , Ww          , Wo          , Ww          , Gg          , Rb^Gvs      
Hh          , Gg          , Gg          , Ww          , Ww          , Wo          , Ww          , Ch          , Gg          , Gs^Fds      , Gg          , Gg          , Re          , Re          , Ce          , Gg          , Gg          , Gg          , Ww          , Rr          , Rr          , Rrc         , Rrc         , Rr          , Rrc         , Rrc         , Rr          , Rr          , Ww          , Gg          , Gg          , Gg          , Ce          , Re          , Re          , Re          , Re          , Gs^Fds      , Gs^Fds      , Gg          , Ch          , Ww          , Wo          , Ww          , Gg          , Rb^Gvs      
Hh          , Gg          , Gg          , Ww          , Wo          , Wo          , Ww          , Gg          , Gg          , Gg          , Gg          , Re          , Re          , Re          , Gg          , Rr^Vhc      , Gg          , Ww          , Rrc^Vhc     , Rrc         , Rrc         , Ch          , Ch          , Ch          , Ch          , Ch          , Rrc         , Rrc         , Rrc^Vhc     , Ww          , Gg          , Rr^Vhc      , Gg          , Gg          , Gs^Vh       , Re          , Re          , Gs^Fds      , Gs^Fds      , Gg          , Gg          , Ww          , Wo          , Ww          , Gg          , Gg          
Gg          , Gg          , Gg          , Ww          , Wo          , Ww          , Ww          , Ch          , Gg          , Gg          , Gg          , Re          , Re          , Gs^Vh       , Gg          , Rr^Vhc      , Gg          , Ww          , Rrc^Vhc     , Rrc         , Rrc         , Ch          , Ch          , 1 Kh        , Ch          , Ch          , Rrc         , Rrc         , Rrc^Vhc     , Ww          , Gg          , Rr^Vhc      , Gg          , Gg          , Gs^Vh       , Re          , Re          , Gg          , Gg          , Gg          , Ch          , Ww          , Wo          , Ww          , Gg          , Gg          
Rb^Gvs      , Rb^Gvs      , Gg          , Ww          , Wo          , Ww          , Ch          , Gg          , Gg          , Gg          , Gg          , Re          , Re          , Re          , Ce          , Rr^Vhc      , Gg          , Ww          , Ww          , Rrc         , Rr          , Ch          , Rrc         , Ch          , Rrc         , Ch          , Rr          , Rrc         , Ww          , Ww          , Gg          , Rr^Vhc      , Ce          , Gg          , Re          , Re          , Re          , Gg          , Gg          , Gg          , Gg          , Ww          , Wo          , Ww          , Ww          , Gg          
Gg          , Rb^Gvs      , Gg          , Ww          , Wo          , Ww          , Gg          , Gg          , Gg          , Gs^Fds      , Gs^Fds      , Gg          , Gs^Vh       , Re          , Re          , Gg          , Gg          , Gg          , Ww^Bsb/     , Rr          , Rrc^Vhc     , Rrc         , Rrc         , Rr          , Rrc         , Rrc         , Rrc^Vhc     , Rr          , Ww^Bsb\     , Gg          , Gg          , Gg          , Gg          , Re          , Re          , Re          , Gg          , Gg          , Gg          , Gg          , Ch          , Ww          , Wo          , Wo          , Ww          , Gg          
Gg          , Gg          , Gg          , Ww          , Wo          , Ww          , Ch          , Gg          , Gg          , Gs^Fds      , Gs^Fds      , Gg          , Gg          , Re          , Re          , Gg          , Rr          , Rr          , Gg          , Ww          , Ww          , Rrc^Vhc     , Rr          , Rr          , Rr          , Rrc^Vhc     , Ww          , Ww          , Gg          , Rr          , Rr          , Gg          , Gg          , Re          , Re          , Gs^Vh       , Gg          , Gg          , Gs^Fds      , Gg          , Gg          , Ww          , Ww          , Wo          , Ww          , Gg          
Hh          , Gg          , Gg          , Ww          , Wo          , Ww          , Ww          , Gg          , Gg          , Gs^Fds      , Gs^Fds      , Gs^Fds      , Gg          , Re          , Rr          , Rr          , Gg          , Gg          , Rr^Vhc      , Gg          , Gg          , Ww          , Ww^Bsb|     , Ww          , Ww^Bsb|     , Ww          , Gg          , Gg          , Rr^Vhc      , Gg          , Gg          , Rr          , Rr          , Re          , Re          , Gg          , Gs^Fds      , Gs^Fds      , Gs^Fds      , Gg          , Ch          , Ww          , Wo          , Wo          , Ww          , Gg          
Hh          , Gg          , Gg          , Ww          , Wo          , Ww          , Ww          , Gg          , Gg          , Gg          , Gg          , Gg          , Rr          , Rr          , Re          , Re          , Gg          , Ce          , Gg          , Rr^Vhc      , Rr^Vhc      , Gg          , Rr          , Rr          , Rr          , Gg          , Rr^Vhc      , Rr^Vhc      , Gg          , Ce          , Gg          , Gg          , Re          , Rr          , Rr          , Gg          , Gg          , Gs^Fds      , Gg          , Gg          , Gg          , Ww          , Wo          , Ww          , Gg          , Gg          
Hh          , Gg          , Gg          , Ww          , Ww          , Wo          , Ww          , Ch          , Rr          , Gg          , Rr          , Rr          , Gg          , Gg          , Re          , Re          , Re          , Gg          , Gg          , Gg          , Ce          , Gg          , Rr          , Rr          , Rr          , Gg          , Ce          , Gg          , Gg          , Gg          , Gg          , Gg          , Re          , Re          , Gs^Vh       , Rr          , Rr          , Gg          , Gg          , Gg          , Ch          , Ww          , Wo          , Ww          , Gg          , Gg          
Hh          , Hh          , Gg          , Ww          , Ww          , Wo          , Wo^Bsb/     , Ww^Bsb/     , Rr          , Rr          , Gg          , Gg          , Gs^Fds      , Gg          , Gs^Vh       , Re          , Re          , Gs^Vh       , Gs^Vh       , Gg          , Re          , Re          , Rr          , Rr          , Rr          , Re          , Re          , Gg          , Re          , Gg          , Gs^Vh       , Gs^Vh       , Re          , Re          , Gg          , Gg          , Gg          , Rr          , Rr          , Rr          , Ww^Bsb\     , Ww          , Wo          , Ww          , Gg          , Gg          
Gg          , Gg          , Gg          , Ww          , Ww^Bsb/     , Wo^Bsb/     , Wo          , Ww          , Ww^Bsb/     , Rr          , Ch          , Gg          , Gg          , Gg          , Gg          , Re          , Re          , Re          , Re          , Re          , Re          , Re          , Rr          , Rr          , Rr          , Re          , Re          , Re          , Re          , Re          , Re          , Re          , Re          , Re          , Gg^Fds      , Gs^Fds      , Gs^Fds      , Gg          , Rr          , Rr          , Ww          , Ww^Bsb\     , Wo^Bsb\     , Ww          , Gg          , Gg          
Gg          , Gg          , Re          , Re          , Re          , Ww          , Ww^Bsb/     , Wo^Bsb/     , Wo          , Ww          , Ww          , Gg          , Ch          , Gg          , Gg          , Gg          , Gg          , Re          , Re          , Re          , Gg          , Gs^Vh       , Rr          , Rr          , Rr          , Gg          , Gg          , Re          , Gs^Vh       , Re          , Re          , Re          , Gg          , Gg          , Gs^Fds      , Gs^Fds      , Gg          , Gg          , Ch          , Ww^Bsb\     , Ww^Bsb\     , Wo          , Ww          , Ww^Bsb\     , Re          , Gg          
Re          , Re          , Re          , Re          , Re          , Re          , Ww          , Ww          , Wo          , Wo          , Ww          , Ww          , Ww          , Gg          , Ch          , Gg          , Gg          , Gg          , Gg          , Gg^Fds      , Gs^Fds      , Gg          , Rr          , Rr          , Rr          , Gg          , Gs^Fds      , Gg          , Gg          , Gg          , Gg          , Gg          , Gg          , Gg          , Gg          , Gg          , Ch          , Gg          , Ww          , Ww          , Wo          , Wo^Bsb\     , Ww^Bsb\     , Re          , Re          , Re          
Re          , Re          , Re          , Re          , Gg          , Gg          , Ww          , Ww          , Ww          , Wo          , Wo          , Ww          , Ww          , Ww          , Ww          , Gg          , Ch          , Gg          , Ch          , Gs^Fds      , Gg          , Gg          , Rr          , Rr          , Rr          , Gg          , Gs^Fds      , Gs^Fds      , Gg          , Gg          , Gg          , Gg          , Gg          , Gg          , Ch          , Gg          , Ww          , Ww          , Wo          , Wo          , Wo          , Ww          , Gg          , Re          , Re          , Re          
Re          , Re          , Gg          , Gg          , Gs^Vh       , Gg          , Gg          , Ww          , Ww          , Ww          , Ww          , Wo          , Wo          , Wo          , Ww          , Ww          , Ww          , Ww          , Ww          , Gg          , Ch          , Gg          , Rr          , Rr          , Rr          , Gg          , Gg          , Gg          , Ch          , Gg          , Ww          , Ch          , Ww          , Gg          , Ww          , Ww          , Wo          , Wo          , Wo          , Wo          , Ww          , Ww          , Gg          , Gg          , Gg          , Re          
Gg          , Gg          , Rb^Gvs      , Rb^Gvs      , Rb^Gvs      , Rb^Gvs      , Rb^Gvs      , Gg          , Gg          , Gg          , Gg          , Ww          , Ww          , Wo          , Wo          , Wo          , Wo          , Wo          , Wo          , Ww          , Ww          , Ww          , Ww^Bsb|     , Rr          , Ww^Bsb|     , Ch          , Ww          , Gg          , Ww          , Ww          , Wo          , Ww          , Wo          , Ww          , Wo          , Wo          , Ww          , Ww          , Ww          , Ww          , Gg          , Gg          , Gg          , Rb^Gvs      , Rb^Gvs      , Gg          
Gg          , Rb^Gvs      , Rb^Gvs      , Rb^Gvs      , Rb^Gvs      , Rb^Gvs      , Gg          , Gg          , Gg          , Gg          , Gg          , Gg          , Gg          , Ww          , Ww          , Wo          , Ww          , Ww          , Ww          , Wo          , Wo          , Wo          , Wo^Bsb|     , Ww          , Ww^Bsb|     , Ww          , Ww          , Ww          , Wo          , Wo          , Wo          , Wo          , Ww          , Wo          , Ww          , Ww          , Gg          , Ww          , Gg          , Gg          , Gg          , Gg          , Gg          , Gs^Vh       , Rb^Gvs      , Rb^Gvs      
Gg          , Rb^Gvs      , Rb^Gvs      , Rb^Gvs      , Gg          , Gg          , Hh          , Gg          , Gg          , Gg          , Rb^Gvs      , Gs^Vh       , Rb^Gvs      , Gg          , Gg          , Ww          , Gg          , Gg          , Gg          , Ww          , Ww          , Ww          , Ww^Bsb|     , Wo          , Ww^Bsb|     , Wo          , Wo          , Wo          , Ww          , Wo          , Ww          , Ww          , Ww          , Ww          , Gg          , Gg          , Gg          , Gg          , Gg          , Gg          , Hh          , Hh          , Hh          , Rb^Gvs      , Rb^Gvs      , Rb^Gvs      
Gg          , Gg          , Gg          , Gg          , Gg          , Hh          , Gg          , Hh          , Gg          , Gg          , Rb^Gvs      , Rb^Gvs      , Rb^Gvs      , Rb^Gvs      , Gg          , Gg          , Gg          , Gg          , Rb^Gvs      , Gg          , Gg          , Ww          , Re          , Ww          , Re          , Ww          , Ww          , Ww          , Ww          , Ww          , Gg          , Ww          , Gg          , Gg          , Gg          , Gg          , Gg          , Gg          , Hh          , Hh          , Hh          , Hh          , Hh          , Gg          , Rb^Gvs      , Rb^Gvs      
Gg          , Gg          , Gg          , Gg          , Gg          , Gg          , Gg          , Gg          , Gg          , Rb^Gvs      , Rb^Gvs      , Rb^Gvs      , Rb^Gvs      , Rb^Gvs      , Gg          , Gg          , Rb^Gvs      , Rb^Gvs      , Rb^Gvs      , Gg          , Gg          , Gg          , Re          , Re          , Re          , Gg          , Gg          , Gg          , Gg          , Gg          , Gg          , Gg          , Rb^Gvs      , Rb^Gvs      , Gg          , Gg          , Gg          , Gg          , Gg          , Gg          , Gg          , Gg          , Gg          , Gg          , Gg          , Rb^Gvs      
