border_size=1
usage=map

_off^_usr, _off^_usr, _off^_usr, _off^_usr, _off^_usr, _off^_usr, _off^_usr, _off^_usr, _off^_usr, _off^_usr, _off^_usr, _off^_usr, _off^_usr, _off^_usr, _off^_usr, _off^_usr, _off^_usr, _off^_usr, _off^_usr, _off^_usr, _off^_usr, _off^_usr, _off^_usr, _off^_usr, _off^_usr, _off^_usr, _off^_usr, _off^_usr, _off^_usr, _off^_usr, _off^_usr, _off^_usr, _off^_usr, _off^_usr, _off^_usr, _off^_usr, _off^_usr, _off^_usr, _off^_usr, _off^_usr, _off^_usr, _off^_usr, _off^_usr, _off^_usr, _off^_usr, _off^_usr, _off^_usr, _off^_usr, _off^_usr, _off^_usr, _off^_usr
_off^_usr, _off^_usr, _off^_usr, _off^_usr, _off^_usr, _off^_usr, _off^_usr, _off^_usr, _off^_usr, _off^_usr, _off^_usr, _off^_usr, _off^_usr, _off^_usr, _off^_usr, _off^_usr, _off^_usr, _off^_usr, _off^_usr, _off^_usr, _off^_usr, _off^_usr, _off^_usr, _off^_usr, _off^_usr, _off^_usr, _off^_usr, _off^_usr, _off^_usr, _off^_usr, _off^_usr, _off^_usr, _off^_usr, _off^_usr, _off^_usr, _off^_usr, _off^_usr, _off^_usr, _off^_usr, _off^_usr, _off^_usr, _off^_usr, _off^_usr, _off^_usr, _off^_usr, _off^_usr, _off^_usr, _off^_usr, _off^_usr, _off^_usr, _off^_usr
_off^_usr, Wot, Wot, Wot, Wot, Wot, Wot, Wot, Wot, Wot, Wot, Wot, Wot, Wot, Wot, Wot, Wot, Wot, Wot, Wot, Wot, Wot, Wot, Wot, _off^_usr, _off^_usr, _off^_usr, Aa^Fpa, Gs^Fp, Gs^Fp, Aa^Fms, Gg^Fp, Gg^Fp, Gg^Fp, Hh, Gg^Fet, Cv, Cv, Cv^Fet, Cv^Ve, Rrc, Wwt^Bsb\, Rrc, Gg^Efm, Gg^Fet, Aa^Fpa, Gs^Fp, Gs^Fp, Aa, Aa^Fpa, _off^_usr
_off^_usr, Wot, Wot, Wot, Wot, Wot, Wot, Wot, Wot, Wot, Wot, Wot, Wot, Wot, Wot, Wot, Wot, Wot, Wot, Wot, Wot, Wot, Wot, Wot, _off^_usr, _off^_usr, _off^_usr, Gg^Fp, Aa^Fpa, Gg^Fet, Gg^Fp, Gg^Fp, Gs^Fmw, Gg^Fet, Cv, Cv, Cv, Cv^Ve, Cv, Kv, Rrc, Wwt, Rrc, Cv, Cv, Gg^Efm, Gg^Fet, Gs^Fp, Gs^Fp, Gg^Fet, _off^_usr
_off^_usr, Wot, Wot, Wot, Wot, Wot, Chw, Wot, Wwt, Wot, Wot, Wot, Wot, Wot, Wot, Wot, Wot, Wot, Wot, Wot, Wot, Ai, Wot, Wot, _off^_usr, _off^_usr, _off^_usr, Ha, Gg^Fp, Gg^Fp, Gs^Fp, Gg^Fdw, Hh, Gg, Cv, Cv, Cv^Ve, Cv^Fet, Kv, Kv, Rrc, Wwt, Rrc, Cv^Ve, Gs^Fmw, Cv, Cv, Gs^Fp, Gg^Fet, Aa^Fpa, _off^_usr
_off^_usr, Wot, Wot, Wot, Wot, Kh, Chw, Chw, Wwt, Wwt, Wwt, Wot, Wot, Wot, Wot, Wot, Wot, Wot, Wwt, Wot, Ai, Wot, Ai, Ai, _off^_usr, _off^_usr, _off^_usr, Hh^Fet, Hh^Fp, Gg^Fp, Gg^Fet, Gs^Fp, Gg^Fet, Cv, Cv^Ve, Cv, Cv^Efm, Cv, Rrc, Rrc, Wwt, Wwt^Bsb\, Rrc, Kv, Cv, Cv, Cv, Gs^Fp, Gs^Fp, Gs^Fmw, _off^_usr
_off^_usr, Wot, Wot, Wot, Wot, Chw, Wwt, Wwr^Bw\, Wwt^Vm, Wwrt, Ai, Wwt^Vm, Wwt, Wot, Wot, Wot, Wwt, Wwt, Ai, Wwt, Ai, Wwt, Coa, Aa, _off^_usr, _off^_usr, _off^_usr, Hh, Gs^Fms, Gg^Fp, Gs^Fmw, Gg^Efm, Gg^Efm, Cv, Cv, Gg^Fet, Rrc, Rrc, Wwt, Wwt^Bsb|, Wwt, Wwt, Rrc, Kv, Cv, Cv, Cv, Gg^Fet, Hh, Gg^Efm, _off^_usr
_off^_usr, Wot, Wot, Wot, Wwt^Vm, Wwt^Vm, Wwrt, Wwf, Wwf, Wwt, Wwt, Wwt, Wwt, Wwrt, Wwt, Ai, Ai, Ai, Ai, Ai^Bw\, Aa, Aa, Aa, Coa, _off^_usr, _off^_usr, _off^_usr, Gs^Fms, Gg^Fp, Aa^Fpa, Gs^Fms, Gg^Fp, Wwt, Rrc, Wwt, Rrc, Wwt, Wwt, Rrc, Rrc, Rrc, Wwt^Bsb/, Rrc, Kv, Cv, Cv^Fet, Cv, Gs^Fp, Gs^Fdw, Hh, _off^_usr
_off^_usr, Wot, Wot, Wot, Wwt, Wwt, Wwt, Wwt, Wwt, Wwt, Wwt, Wwrt, Wwt, Wwt, Ww^Bw\, Ai, Ai, Ai^Bw\, Aa, Aa, Aa, Aa, Aa^Vo, Aa, _off^_usr, _off^_usr, _off^_usr, Aa^Fpa, Aa^Fpa, Gg^Fp, Wwt, Wwt, Aa^Fet, Wwt^Bsb|, Wwt, Wwt, Cv, Rrc, Kv, Kv, Rrc, Wwt, Rrc, Cv, Cv^Ve, Cv, Cv, Gs^Fmw, Gs^Fp, Gg^Efm, _off^_usr
_off^_usr, Wot, Wot, Wot, Wot, Wwt, Wwt, Wwrt, Wwt, Wwt, Wot, Ai, Ai^Bw\, Ai, Ai, Ai^Bw\, Aa, Aa, Aa, Re, Cha, Aa, Re, Aa, _off^_usr, _off^_usr, _off^_usr, Aa^Fpa, Wwt, Wwt, Aa^Fpa, Gg^Fdw, Gg^Efm, Rrc, Cv^Ve, Cv, Cv^Efm, Cv, Cv, Kv, Rrc, Wwt, Rrc, Cv, Cv, Cv, Cv, Aa, Gs^Fp, Gg^Fet, _off^_usr
_off^_usr, Wot, Wot, Wot, Wot, Wot, Wot, Wwt^Vm, Wot, Wwt, Wot, Ai, Ai, Ai^Bw\, Re, Aa, Aa, Aa, Cea, Re, Ch, Re, Chr, Aa, _off^_usr, _off^_usr, _off^_usr, Wwt, Aa^Fet, Gg^Fp, Gg^Efm, Gg^Fp, Gg^Fet, Cv, Cv, Cv^Fet, Cv, Cv^Ve, Cv, Gg^Fet, Rrc, Wwt, Rrc, Cv^Fet, Cv^Ve, Cv, Gg^Efm, Gg^Fet, Hh, Aa^Fpa, _off^_usr
_off^_usr, Wot, Wot, Wot, Wot, Wot, Wot, Wot, Wot, Wot, Wot, Ai, Ai^Bw\, Aa, Aa, Aa, Aa, Re, Re, Chr, Kha, Ce, Aa, Aa, _off^_usr, _off^_usr, _off^_usr, Aa^Fpa, Aa^Fpa, Aa^Fpa, Aa^Fpa, Gg^Fp, Hh, Gg^Efm, Cv, Cv^Ve, Cv^Fet, Cv, Cv, Cv^Ve, Rrc, Wwt^Bsb/, Wwt, Cv, Gg^Efm, Gg^Fet, Gg^Fmw, Gs^Fms, Aa^Fpa, Gg^Efm, _off^_usr
_off^_usr, Wot, Wot, Wot, Wot, Wot, Wot, Wot, Wot, Wot, Wot, Wwt, Ai, Aa, Aa, Aa, Aa^Vc, Aa, Chr, Ch, Cha, Chr, Cha, Re, _off^_usr, _off^_usr, _off^_usr, Aa^Fpa, Ha, Ha, Aa, Gs^Fp, Aa^Fpa, Gg^Fet, Gg^Efm, Cv, Cv, Cv, Gg^Efm, Cv, Gg^Efm, Wwt, Wwt, Gg^Fet, Aa^Fpa, Gg^Fp, Gs^Fp, Hh, Aa, Aa^Fpa, _off^_usr
_off^_usr, _off^_usr, _off^_usr, _off^_usr, _off^_usr, _off^_usr, _off^_usr, _off^_usr, _off^_usr, _off^_usr, _off^_usr, _off^_usr, _off^_usr, _off^_usr, _off^_usr, _off^_usr, _off^_usr, _off^_usr, _off^_usr, _off^_usr, _off^_usr, _off^_usr, _off^_usr, _off^_usr, _off^_usr, _off^_usr, _off^_usr, _off^_usr, _off^_usr, _off^_usr, _off^_usr, _off^_usr, _off^_usr, _off^_usr, _off^_usr, _off^_usr, _off^_usr, _off^_usr, _off^_usr, _off^_usr, _off^_usr, _off^_usr, _off^_usr, _off^_usr, _off^_usr, _off^_usr, _off^_usr, _off^_usr, _off^_usr, _off^_usr, _off^_usr
_off^_usr, _off^_usr, _off^_usr, _off^_usr, _off^_usr, _off^_usr, _off^_usr, _off^_usr, _off^_usr, _off^_usr, _off^_usr, _off^_usr, _off^_usr, _off^_usr, _off^_usr, _off^_usr, _off^_usr, _off^_usr, _off^_usr, _off^_usr, _off^_usr, _off^_usr, _off^_usr, _off^_usr, _off^_usr, 1 _off^_usr, _off^_usr, _off^_usr, _off^_usr, _off^_usr, _off^_usr, _off^_usr, _off^_usr, _off^_usr, _off^_usr, _off^_usr, _off^_usr, _off^_usr, _off^_usr, _off^_usr, _off^_usr, _off^_usr, _off^_usr, _off^_usr, _off^_usr, _off^_usr, _off^_usr, _off^_usr, _off^_usr, _off^_usr, _off^_usr
_off^_usr, Aa, Aa, Aa, Ms, Aa, Wot, Ai, Ai, Aa, Aa, Aa, Aa, Aa, Rr, Rr, Aa, Aa, Aa, Aa, Aa, Aa, Aa, Aa, _off^_usr, _off^_usr, _off^_usr, Gd, Gd, Re, Re, Aa, Cea, Ce, Gs, Gd, Gs, Rr, Rr, Rr, Gd, Gd, Aa, Ce, Ce, Gd, Gd, Re, Re, Gd^Vh, _off^_usr
_off^_usr, Aa, Aa, Ms, Ms, Ms, Wot, Wot, Wot, Ai, Aa, Aa, Aa, Rr, Rr, Rr, Aa, Aa, Aa, Aa, Ha, Aa, Aa, Aa, _off^_usr, _off^_usr, _off^_usr, Rr, Rr, Re, Re, Aa, Gd, Gd, Rr^Vhc, Rr^Vhc, Aa, Rr, Rr, Rr, Gs, Rr^Vhc, Rr^Vhc, Gs, Aa, Gs, Aa, Re, Rr, Rr, _off^_usr
_off^_usr, Aa, Aa^Fpa, Aa, Aa, Ms, Ms, Wot, Ai, Ai, Aa, Aa, Rr, Rr, Rr, Aa, Aa, Aa, Aa, Ha^Vc, Ha, Aa, Aa, Aa, _off^_usr, _off^_usr, _off^_usr, Aa, Aa, Rr, Rr, Gd, Gd, Rr^Vhc, Gd, Gs, Wwt, Wwt^Bsb|, Ww, Wwt^Bsb|, Wwt, Gd, Gd, Rr^Vhc, Gs, Aa, Rr, Rr, Re, Re, _off^_usr
_off^_usr, Aa^Fpa, Aa, Aa^Fpa, Aa, Aa, Aa, Aa, Aa^Fda, Aa, Aa^Fda, Aa, Rr, Rr, Rr, Aa, Aa, Aa, Aa, Ha^Fpa, Ha^Fpa, Aa^Fpa, Aa^Fpa, Aa, _off^_usr, _off^_usr, _off^_usr, Aa, Re, Re, Gd, Rr, Rr, Aa, Wwt, Wwt, Rrc^Vhc, Rr, Rr, Rr, Rrc^Vhc, Wwt, Wwt, Gs, Rr, Rr, Gs, Gd, Aa, Re, _off^_usr
_off^_usr, Aa, Aa, Aa, Aa, Aa, Aa, Aa, Aa, Aa^Fda, Aa^Fda, Aa, Rr, Rr, Aa, Aa, Aa, Aa^Fpa, Ha^Fpa, Ha^Fpa, Aa^Fpa, Aa^Fpa, Aa^Fpa, Aa, _off^_usr, _off^_usr, _off^_usr, Gd^Vh, Re, Re, Gd, Gs, Gd, Wwt^Bsb\, Rr, Rrc^Vhc, Rrc, Rrc, Rr, Rrc, Rrc, Aa^Vhca, Rr, Wwt^Bsb/, Gs, Gd, Gd, Aa, Re, Re, _off^_usr
_off^_usr, Aa, Ms, Aa, Aa, Aa, Aa, Aa, Aa, Aa^Fda, Aa, Rr, Rr, Rr, Aa, Aa, Aa, Aa^Fpa, Aa, Ha^Fpa, Aa^Fpa, Aa^Fpa, Aa^Fpa, Aa, _off^_usr, _off^_usr, _off^_usr, Re, Re, Cea, Rr^Vhc, Aa, Wwt, Wwt, Rrc, Rr, Cha, Rrc, Cha, Rrc, Cha, Rr, Rrc, Wwt, Wwt, Gd, Rr^Vhc, Ce, Aa, Re, _off^_usr
_off^_usr, Aa, Ms, Ms, Ha, Aa, Aa, Aa, Aa, Aa, Cha, Rr, Rr, Rr, Chr, Aa, Aa, Aa, Aa, Aa, Aa, Aa, Aa, Aa, _off^_usr, _off^_usr, _off^_usr, Re, Gd^Vh, Gs, Rr^Vhc, Gs, Wwt, Rrc^Vhc, Rrc, Rrc, Cha, Cha, Kha, Cha, Cha, Rrc, Rrc, Rrc^Vhc, Wwt, Gs, Rr^Vhc, Gs, Gd, Gd^Vh, _off^_usr
_off^_usr, Aa, Ha, Ms, Ms^Vhh, Ms, Aa, Aa, Aa, Aa, Chr, Khr, Rr, Khr, Cha, Aa, Aa, Aa, Aa, Aa, Aa, Aa, Aa, Aa, _off^_usr, _off^_usr, _off^_usr, Re, Re, Gs, Rr^Vhc, Gd, Wwt, Rrc^Vhca, Rrc, Rrc, Cha, Cha, Cha, Cha, Cha, Rrc, Aa, Rrc^Vhc, Wwt, Gd, Rr^Vhc, Gs, Gs, Gd^Vh, _off^_usr
_off^_usr, Aa, Aa, Ms, Ms, Ha, Ms, Aa, Aa, Aa, Aa, Rr, Rr, Aa, Aa, Aa, Aa, Aa, Aa, Aa, Aa^Fpa, Aa^Fpa, Aa^Fpa, Aa, _off^_usr, _off^_usr, _off^_usr, Aa, Re, Ce, Aa, Gs, Gd, Wwt, Rr, Rr, Rrc, Aa, Rr, Rrc, Rrc, Rr, Rr, Wwt, Gs, Gd, Gs, Cea, Aa, Re, _off^_usr
_off^_usr, Aa, Aa, Aa, Aa, Ms, Ms, Aa, Aa, Aa, Aa, Rr, Rr, Rr, Aa, Aa, Aa, Aa, Aa, Aa, Aa, Aa, Aa^Fpa, Aa^Fpa, _off^_usr, _off^_usr, _off^_usr, Gd^Vh, Re, Re, Aa, Gd, Rr, Wwt^Bsb/, Wwt, Rrc^Vhca, Rrc^Vhc, Rrc, Rr, Rrc, Rrc^Vhc, Rrc^Vhca, Wwt, Wwt^Bsb\, Rr, Gs, Gd, Gd, Re, Re, _off^_usr
_off^_usr, Aa, Aa^Fda, Aa, Aa, Ms, Aa, Aa, Aa, Aa, Aa, Aa, Rr, Rr, Aa, Aa, Aa, Aa, Aa, Aa, Aa, Aa^Vc, Aa^Fpa, Aa^Fpa, _off^_usr, _off^_usr, _off^_usr, Gs, Re, Re, Rr, Rr, Gs, Aa, Gd, Wwt, Wwt, Rr, Wwt, Rr, Wwt, Wwt, Aa, Gd, Gd, Rr, Rr, Gs, Re, Re, _off^_usr
_off^_usr, _off^_usr, _off^_usr, _off^_usr, _off^_usr, _off^_usr, _off^_usr, _off^_usr, _off^_usr, _off^_usr, _off^_usr, _off^_usr, _off^_usr, _off^_usr, _off^_usr, _off^_usr, _off^_usr, _off^_usr, _off^_usr, _off^_usr, _off^_usr, _off^_usr, _off^_usr, _off^_usr, _off^_usr, _off^_usr, _off^_usr, _off^_usr, _off^_usr, _off^_usr, _off^_usr, _off^_usr, _off^_usr, _off^_usr, _off^_usr, _off^_usr, _off^_usr, _off^_usr, _off^_usr, _off^_usr, _off^_usr, _off^_usr, _off^_usr, _off^_usr, _off^_usr, _off^_usr, _off^_usr, _off^_usr, _off^_usr, _off^_usr, _off^_usr
_off^_usr, _off^_usr, _off^_usr, _off^_usr, _off^_usr, _off^_usr, _off^_usr, _off^_usr, _off^_usr, _off^_usr, _off^_usr, _off^_usr, _off^_usr, _off^_usr, _off^_usr, _off^_usr, _off^_usr, _off^_usr, _off^_usr, _off^_usr, _off^_usr, _off^_usr, _off^_usr, _off^_usr, _off^_usr, _off^_usr, _off^_usr, _off^_usr, _off^_usr, _off^_usr, _off^_usr, _off^_usr, _off^_usr, _off^_usr, _off^_usr, _off^_usr, _off^_usr, _off^_usr, _off^_usr, _off^_usr, _off^_usr, _off^_usr, _off^_usr, _off^_usr, _off^_usr, _off^_usr, _off^_usr, _off^_usr, _off^_usr, _off^_usr, _off^_usr
