border_size=1
usage=map

Wo, Wo, Wo, Wo, Wo, Wo, Wo, Wo, Wo, Wo, Wo, Wo, Wo, Wo, Wo, Wo, Wo, Wo, Wo, Ww, Ww, Ww, Ww, Ww, Ww, Ww, Ww, Ds, Ds, Ds, Ds, Gs, Gg, Gll^Fmw, Gll^Fmw, Gll^Fmw, Gs, Gs, Gll^Fmw, Gll^Fmw, Gs, Gs, Gll^Fmw, Gs, Gs, Gs, Gs, Gll^Fmw, Gll^Fmw, Gll^Fmw, Gll^Fmw, Gll^Fmw, Gll^Fmw, Gll^Fmw, Gll^Fmw, Gll^Fmw, Gll^Fmw, Gll^Fmw
Wo, Wo, Wo, Wo, Wo, Wo, Wo, Wo, Wo, Wo, Wo, Wo, Wo, Wo, Wo, Wo, Wo, Ww, Ww, Ww, Ww, Ww, Ww^Vm, Ww, Ds, Ds, Ds, Ds, Ds, Ds, Gg, Gg, Gg, Gll^Fmw, Gs, Gll^Fmw, Gll^Fmw, Gll^Fp, Gs, Gll^Fmw, Gs, Gll^Fmw, Gs, Gll^Fp, Gs, Gll^Fmw, Gs, Gll^Fmw, Re^Vl, Gll^Fmw, Gll^Fmw, Gll^Fmw, Gll^Fmw, Gll^Fmw, Gll^Fmf, Gll^Fmw, Gll^Fmw, Gll^Fp
Wo, Wo, Wo, Wo, Wo, Wo, Wo, Wo, Wo, Wo, Wo, Wo, Wo, Wo, Wo, Wo, Ww^Vm, Ww, Ww, Ww, Ds, Ds, Ds, Ds, Ds, Ds, Ds, Ds, Ds, Ds, Gg, Gs, Gg, Gg, Gll^Fmw, Gg, Gll^Fmw, Gll^Fp, Gll^Fmw, Gs, Gs, Gll^Fp, Gll^Fmw, Gll^Fp, Gll^Fp, Gll^Fmf, Gll^Fmf, Gll^Fmw, Gll^Fmf, Re, Re, Re^Vh, Re, Gll^Fmw, Gll^Fmw, Gll^Fp, Gll^Fp, Gll^Fmw
Wo, Wo, Wo, Wo, Wo, Wo, Wo, Wo, Wo, Wo, Wo, Wo, Wo, Wo, Ww, Ww, Ww, Ww, Ww, Ww, Ds, Ds, Ds, Ds, Gg, Gg, Gg, Ds, Gg, Gg, Gg, Gg, Gs, Gs, Gg, Gs, Gs, Gll^Fmw, Gll^Fp, Gll^Fmw, Gll^Fmw, Gll^Fmw, Gll^Fmw, Gg^Ve, Gll^Fmw, Gll^Fmw, Ww, Gll^Fmw, Gll^Fmw, Gs, Gll^Fp, Re, Gll^Fmw, Re^Vl, Gll^Fmw, Gll^Fmw, Gll^Fmw, Gll^Fmw
Wo, Wo, Wo, Wo, Wo, Wo, Wo, Wo, Wo, Wo, Wo, Wo, Ww, Ww, Ww, Ww, Ww, Ww, Ww, Ww, Ds, Ds, Ds, Gg, Gg, Gg, Gg, Gg, Hh, Gg, Mm, Hh, Hh, Hh, Hh, Gs, Gll^Fmw, Gll^Fmw, Gs, Gll^Fmf, Gs, Gs, Gs, Gll^Fmw, Gll^Fmw, Ww, Ww, Ww, Ww, Ww, Gll^Fmw, Re^Vh, Gll^Fmf, Gll^Fmw, Gll^Fmw, Gll^Fp, Gll^Fmw, Gll^Fp
Wo, Wo, Wo, Wo, Wo, Wo, Wo, Wo, Wo, Wo, Wo, Wo, Ww, Ww, Ww, Ww, Ww, Ww, Ds, Ds, Ds, Ds, Gg, Gg, Gg, Gs, Gg, Hh, Hh, Hh, Mm, Hh, Hh, Hh, Gs, Gs, Gll^Fmw, Gll^Fmw, Gll^Fmw, Gll^Fmw, Gs, Gll^Fmw, Gll^Fp, Gll^Fmw, Gll^Fmw, Ww, Ww, Ww, Ww, Ww, Gll^Fmw, Gll^Fmf, Gll^Fmw, Gll^Fmf, Gll^Fmw, Gs, Gll^Fmw, Gll^Fp
Wo, Wo, Wo, Wo, Wo, Wo, Wo, Wo, Wo, Wo, Ww^Vm, Ww, Ww, Ww, Ww, Ww, Ww, Ds, Ds, Ds, Ds, Gg, Gs, Gg, Gg, Gg, Gs, Hh, Hh, Hh^Vhh, Hh, Hh, Gs, Gs, Gs, Gs, Gll^Fmw, Gll^Fmf, Gll^Fmf, Gll^Fmw, Gs, Gs, Gll^Fmw, Gll^Fmf, Gs, Ww, Gll^Fmw, Ww, Gll^Fmw, Gll^Fmw, Gs, Re^Vl, Gll^Fmw, Gll^Fmw, Gll^Fmw, Gll^Fp, Gll^Fp, Gll^Fmw
Wo, Wo, Wo, Wo, Wo, Wo, Wo, Wo, Wo, Wo, Ww, Ww, Ww, Ww, Ww, Ww, Ww, Ds, Gg, Gg, Gg, Gg, Gg, Gg, Gs^Fmw, Gll^Fmw, Gs, Hh, Hh, Hh, Gs, Gs, Gs, Gs, Gs, Gll^Fmw, Gs, Gll^Fmw, Gs, Gll^Fmw, Gll^Fmw, Gs, Gll^Fmw, Gll^Fmw, Gs, Gs, Gll^Fmw, Gll^Fmw, Gll^Fmw, Gll^Fp, Gll^Fmw, Gs, Gll^Fp, Gll^Fmw, Gll^Fmw, Gll^Fmw, Gll^Fmf, Gll^Fmw
Wo, Wo, Wo, Wo, Wo, Wo, Wo, Wo, Wo, Ww, Ww, Ww, Ww, Ww, Ww, Ww, Ww^Vm, Ds, Gs, Gs, Gs, Gs, Gg, Gs, Gs, Gll^Fp, Gll^Fmw, Gs, Gs, Gs, Gs, Gs, Gs, Gs, Gs, Gll^Fp, Gs, Gs, Gll^Fp, Gll^Fmw, Gs, Gll^Fmw, Gs, Gs, Gll^Fmw, Gll^Fp, Gll^Fmw, Gll^Fmf, Gs, Gll^Fmw, Re, Re, Re, Gs, Gll^Fmw, Gll^Fmw, Gll^Fmw, Gll^Fmw
Wo, Wo, Wo, Wo, Wo, Wo, Ww, Wo, Ww, Ww, Ww, Ww, Ww, Ww, Ds, Ds, Ds, Ds, Gs, Gg^Vct, Re^Vct, Gs, Gs, Gs, Gs, Gs^Fmw, Gll^Fmw, Gll^Fmf, Gs^Fmw, Gs, Gs, Gs, Gs, Gs, Gs, Gll^Fmw, Gs^Vl, Gll^Fmw, Gll^Fmw, Gll^Fmf, Gll^Fmw, Gll^Fmw, Gll^Fmw, Gll^Fmw, Re, Gll^Fmw, Re, Re, Re, Re, Re, Re, Re, Re, Re, Re, Re, Re
Wo, Wo, Wo, Wo, Ww, Ww, Ww, Ww, Ww, Ww, Ww, Ww, Ds, Ds, Gs^Vct, Ds, Ce, Ce, Ce, Gg, Gs, Gs, Gs, Gs, Gs, Gs, Gs, Gll^Fmw, Gs, Gs^Fmw, Re, Re, Re, Re, Re, Re, Re, Re, Re, Re, Re, Re, Re, Re, Re, Re, Re, Re, Gs, Re, Gll^Fmw, Gll^Fmw, Gs, Re, Gs, Gll^Fmw, Gs, Gs
Ww, Wo, Ww, Ww, Ww, Ww, Ww, Ww, Ww, Ww, Ds, Ds, Gg, Gs^Vct, Ce, Ce, 1 Ke, Ce, Ce, Gs, Gs, Re^Vct, Gs, Gs, Gs, Gs, Gs, Gs, Re, Re, Re, Re, Re, Re, Re, Re, Re, Re, Gll^Fmw, Re, Gll^Fmw, Re, Gs, Gll^Fmw, Gll^Fp, Gll^Fmw, Gll^Fmw, Gll^Fmw, Gll^Fp, Gg^Ve, Gll^Fmw, Gll^Fp, Gll^Fmw, Gll^Fmw, Gs, Gll^Fp, Gll^Fmw, Gs
Ww, Ww, Ww, Ww, Ww, Ww, Ww, Ww, Ww, Ds, Gg, Gg, Rb^Gvs, Gs, Gs, Ce, Ce, Ce, Gs, Gs, Re^Vct, Gs, Gs, Gs, Re, Gs, Re, Re, Re, Re, Gs, Gs, Gs, Gs, Gs, Gs, Gs, Gs, Gll^Fmw, Gll^Fmw, Gll^Fmw, Gll^Fmw, Gll^Fmw, Gll^Fmw, Gs, Gs^Fmw, Gs^Fmw, Gll^Fmw, Gll^Fmf, Gll^Fmw, Gll^Fmw, Gll^Fmf, Gll^Fmw, Gs, Gll^Fmw, Gll^Fp, Gs, Gll^Fmw
Ww, Ww, Ww, Ww, Ww, Ww, Ds, Ww^Vm, Ds, Ds, Rb^Gvs, Rb^Gvs, Rb^Gvs, Rb^Gvs, Gg, Ce, Gs, Gs, Re^Vct, Gs, Gs, Gs, Re, Re, Re, Re, Re, Re, Gs, Gs, Gs, Gs, Gs, Gs, Gs, Gs, Gll^Fmw, Gll^Fmw, Gll^Fmw, Gll^Fmf, Gll^Fmw, Gll^Fmw, Gs, Gll^Fp, Gs^Fmw, Gs^Fmw, Gll^Fmw, Gs, Gll^Fmw, Gll^Fmw, Hhd^Fmw, Gll^Fmw, Hhd^Fmf, Gll^Fmw, Gll^Fmw, Gll^Fmw, Gll^Fmw, Gs
Ww, Ww, Ww, Ww, Ds, Ds, Gg, Gg, Gg, Rb^Gvs, Rb^Gvs, Rb^Gvs, Rb^Gvs, Rb^Gvs, Gs, Gs, Re^Vct, Gs, Gs, Gs, Gs, Gs, Re, Re, Re, Gs^Vl, Gs, Gs, Gs, Gs, Gs, Gs, Gs, Gs, Gs, Gs, Gs, Gs^Fmw, Gs^Fmw, Gs^Fmw, Gs, Gll^Fp, Gs^Fmw, Gs, Gs, Gs, Gll^Fmw, Gll^Fmf, Gs^Fmw, Gll^Fmw, Hhd, Hhd, Mm, Hhd, Gll^Fmw, Gll^Fmw, Gll^Fmf, Gll^Fmw
Ww, Ww, Ds, Ds, Gg, Gg, Rr, Rr^Vhc, Gs, Gg, Ce, Rb^Gvs, Gs, Gs, Gs, Gs, Gs, Gs, Gs, Gs, Re, Re, Re, Re, Gs, Gs, Gs, Gs, Hh, Hh, Hh, Hh, Hh, Hh, Hhd^Fmw, Hhd, Gs^Fmw, Gs^Fmw, Gll^Fmf, Gs^Fmw, Gll^Fmw, Gs^Fmw, Hhd, Gll^Fmw, Hhd, Gll^Fp, Gs, Gs^Fmw, Gll^Fmw, Hhd^Fmw, Hhd, Mm, Hhd, Mm, Gll^Fmw, Gll^Fmw, Gll^Fmw, Gll^Fmw
Ds, Ds, Rb^Gvs, Gs^Vh, Gs, Rr, Rr, Re, Re, Re^Vh, Ce, Gs, Gg, Gs, Gs, Gg, Gs, Gs, Re, Re, Re, Re, Gs, Gs, Gs, Gs, Gs, Hh, Hh, Hh, Hhd^Vhh, Hh, Hh, Hhd, Hhd^Fmw, Hhd^Fp, Hhd^Fmw, Gs^Fmw, Gs^Fmw, Gll^Fp, Gs^Fdw, Hhd, Hhd^Fmw, Mm, Hhd^Fmw, Hhd^Fmw, Gll^Fmw, Gll^Fmw, Gll^Fmw, Gs, Hhd, Hhd, Gll^Fmw, Gll^Fmw, Gs, Gs, Gll^Fp, Gs
Rb^Gvs, Rb^Gvs, Rb^Gvs, Rb^Gvs, Re^Vh, Gg, Re, Rr, Rr, Ket, Rr, Gs, Gs, Gs, Gs, Gs, Gs, Gs, Re, Re, Gs, Gs, Gs, Gs, Hh, Hh, Hh, Hh, Hh, Hh, Hh, Hhd, Hhd, Hhd, Hhd^Fp, Hhd, Hhd^Fmw, Gs^Fmw, Gll^Fmw, Gll^Fmf, Gll^Fmw, Hhd^Fmw, Gll^Fp, Gll^Fmw, Gll^Fmw, Gll^Fmw, Gg^Ve, Gll^Fmw, Gll^Fmw, Gs, Gll^Fmw, Gll^Fmw, Gll^Fmf, Gll^Fmw, Gs, Gll^Fmw, Gll^Fmw, Gll^Fmw
Rb^Gvs, Rb^Gvs, Rb^Gvs, Rb^Gvs, Ce, Gs, Ce, Ket, Re, Rr, Rr, Rr, Re, Gs, Re, Re, Re, Re, Re, Re, Gs, Gs, Gs, Hh, Hh, Hh, Hh, Gs, Hh, Gs, Hhd, Hhd, Hh, Hhd^Fp, Hhd^Fmw, Hhd^Fmw, Hhd, Gs, Gs, Gll^Fmw, Gll^Fmw, Gll^Fmw, Gll^Fmw, Gs, Gll^Fmw, Gll^Fmw, Gll^Fp, Gll^Fmw, Gll^Fp, Gll^Fmw, Gll^Fmf, Gll^Fmw, Gs, Gll^Fp, Gll^Fmw, Gg^Ve, Gll^Fmw, Gll^Fmw
Rb^Gvs, Rb^Gvs, Gg, Gs, Gs, Ce, Gg, Gs, Gs, Gs, Gs, Re, Re, Re, Re, Re, Gs^Vl, Gs, Gs, Gs, Gs, Gs, Hh, Hh, Hhd, Hh, Hh^Vhh, Hhd, Hhd, Hh, Hh, Hhd, Hhd, Hhd, Hhd, Hhd^Fmw, Hhd, Gs, Gs, Gll^Fmw, Gs, Gll^Fp, Gll^Fmw, Gll^Fmw, Gll^Fmf, Gll^Fmw, Gs, Gll^Fp, Gll^Fmw, Gll^Fmw, Gll^Fmw, Gll^Fmw, Gs, Gs, Gs, Gll^Fmw, Gll^Fp, Gll^Fp
Gs, Gs, Rb^Gvs, Rb^Gvs, Gs, Gs, Gs, Gg, Gs, Gs, Re, Re, Re, Re, Re, Re, Gs, Gs, Gs, Gs, Hh, Hh, Hh, Hh, Hhd, Hhd, Mm, Mm, Mm, Mm, Hhd, Gs, Hhd, Gs, Hhd, Hhd, Gs, Gs, Gs, Gs, Gs, Gll^Fmw, Gll^Fmw, Gll^Fp, Gll^Fmw, Gll^Fmw, Gll^Fmw, Gll^Fmw, Gll^Fmw, Gll^Fmw, Gll^Fp, Gll^Fmw, Gll^Fmw, Gs, Gll^Fmw, Gll^Fmw, Gll^Fmw, Gll^Fmw
Gs, Rb^Gvs, Rb^Gvs, Rb^Gvs, Gs, Gg, Gs, Gs, Gs, Re, Re, Re, Gs, Gs, Gs, Gs, Gs, Gs, Gs, Hh, Hh, Hh, Hh, Hhd, Mm, Mm, Mm, Mm, Mm, Mm, Hhd, Hh^Vhh, Hhd, Hhd, Hhd, Hhd, Gs, Gs, Rb^Gvs, Rb^Gvs, Rb^Fdw, Gs, Gs, Gll^Fmw, Gs, Gll^Fmw, Gs, Gll^Fmw, Gll^Fmw, Gll^Fmw, Re^Vl, Gll^Fmw, Gll^Fmw, Gll^Fmw, Gll^Fmf, Gll^Fmf, Gll^Fmw, Gs
Gs, Rb^Gvs, Gs, Gs, Gs, Gs, Gs, Gs, Re, Re, Re, Re, Gs, Gs, Gs, Gs, Gs, Gs, Hh, Hh, Hh, Gs, Hh, Hhd, Mm, Mm, Mm, Mm, Mm, Hhd, Hhd, Hhd, Hhd, Hhd, Hhd, Hhd, Rb^Gvs, Rb^Gvs, Rb^Fdw, Gll^Fdf, Rb^Gvs, Rb^Gvs, Gs, Gs, Gs, Gs, Gll^Fmw, Gll^Fmw, Re^Vl, Re, Re, Gll^Fmw, Gll^Fmw, Gll^Fmf, Gll^Fmw, Gll^Fmf, Gs, Gs
Gg, Gs, Gs, Gs, Gs, Gs, Gs, Re, Re, Re, Gs, Gs, Gs, Gs, Gs, Gs, Hh, Hh, Gs, Hh, Hhd, Hh, Mm, Mm, Mm, Mm, Mm, Mm, Chr, Mm, Hhd, Gs, Hhd, Hhd, Hhd, Gs, Gs, Rb^Fdw, Rb^Gvs, Rb^Gvs, Gs, Gs, Ce, Gs, Gs, Gs, Gs, Gs, Gs, Gll^Fmw, Gll^Fmw, Re^Vl, Gll^Fmw, Gs, Gll^Fmw, Gll^Fmw, Gll^Fp, Gs
Gs, Gs, Gs, Gs, Gs, Gs, Re, Re, Re, Gs^Vl, Gs, Gs, Gs, Gs, Gll^Fmw, Gs, Hh, Hh, Hhd, Hh, Hhd, Hhd, Mm, Mm, Mm, Mm, Hhd^Vhc, Khr, Chr, Chr, Hhd, Hhd, Hhd, Hhd, Gs, Gs, Gs, Gs, Rb^Fdw, Gs, Ce, Gs^Vh, Re, Ce, Ket, Gs, Rb^Gvs, Rb^Gvs, Rb^Fdw, Gs, Gs, Gll^Fmw, Gs, Gll^Fmw, Gll^Fmf, Gll^Fmw, Gs, Gll^Fmw
Gs, Gs, Gs, Gs, Re, Re, Re, Re, Gs, Gs, Gs, Gs, Gll^Fmw, Gll^Fp, Gll^Fmf, Gs, Hh^Fmw, Hh, Hhd^Fmw, Hhd, Mm, Mm, Mm, Mm, Mm, Mm, Mm, Chr, Hhd, Hhd, Hhd, Hhd, Hhd, Gs, Gs, Gs, Rb^Fdw, Rb^Fdw, Rb^Gvs, Gs, Gs, Gs, Re, Re, Ce, Gs, Rb^Fdw, Rb^Fdw, Rb^Gvs, Rb^Gvs, Rb^Fdw, Gs, Gs, Gs^Fmw, Gll^Fmw, Gs, Gll^Fmw, Gs
Gs, Gs, Gs, Re, Re, Re, Re, Gs, Gs, Gs, Gs, Gll^Fmw, Gll^Fmf, Gll^Fmw, Gll^Fmf, Gs^Fmw, Gll^Fmw, Gll^Fmw, Hh^Fmf, Hhd^Fmw, Mm^Vhh, Mm, Mm, Mm, Hhd, Hh, Hhd, Hhd, Hhd, Hhd, Hhd, Hhd, Gs, Gs, Gs, Gs, Rb^Gvs, Rb^Gvs, Rb^Gvs, Gs^Vh, Gs, Rr^Vhc, Gs, Re^Vh, Ce, Gs, Rb^Gvs, Rb^Gvs, Gll^Fdf, Rb^Fdw, Gs, Gs, Gs, Gs, Gll^Fp, Gs, Gll^Fmw, Gll^Fmw
Gs, Gs, Re, Re, Re, Re, Gs, Gs, Gs, Gs, Gll^Fmw, Gll^Fmw, Gs, Gll^Fmw, Hh, Hh, Hhd, Hh, Hh, Hh, Mm, Mm, Hhd, Hhd, Hhd, Hhd, Gs, Hhd, Hhd, Hhd, Hhd, Hhd, Gs, Gs, Gs, Gs, Rb^Gvs, Rb^Gvs, Gll^Fdf, Gs, Gs, Ce, Ce, Re, Gs, Gs, Gs, Rb^Fdw, Gs, Gs, Gs, Gs, Gs, Gs, Gs, Gs^Fmw, Gll^Fmf, Gs
Re, Re, Re, Re, Gs, Re, Re, Re, Re, Gs, Gs, Gs, Gs, Gs, Hh, Hh, Hh, Gs, Hhd, Hhd, Hhd, Hhd, Hh, Gs, Hh, Hh, Hh, Hhd, Hhd, Hhd, Gs, Gs, Gs, Hhd, Gs, Gs, Rb^Fdw, Rb^Fdw, Rb^Gvs, Rb^Gvs, Rb^Gvs, Gs, Gs, Gs, Rb^Gvs, Rb^Gvs, Rb^Fdw, Gs, Gs, Gs, Gs, Gs, Gs, Gs, Gs, Gs, Gs, Gll^Fmw
Re, Re, Gs, Gs, Gs, Gs, Gs, Gs, Re, Gs, Gs, Gs, Gs, Hh, Hh, Hhd, Hhd, Hhd, Hh, Hhd^Vhh, Hhd, Hhd, Hh, Hh, Wo, Hh, Wo, Hh, Gg, Gs, Gs, Gs, Gs, Gs, Gs, Gs, Rb^Gvs, Rb^Gvs, Rb^Gvs, Rb^Gvs, Gs, Gs, Gs, Rb^Gvs, Rb^Fdw, Rb^Fdw, Rb^Gvs, Rb^Gvs, Rb^Fdw, Gs, Gs, Ur, Ur, Gs, Gs, Gs, Gs, Xu
Gs, Gs, Gs, Gs, Rb^Gvs, Gs, Gs^Vh, Gs, Re, Re, Gs, Gs^Vh, Gs, Hh, Hh, Hh, Hhd, Hhd, Gs, Hhd, Hhd, Gs, Hh, Hh, Wo, Wo, Wo, Ww, Gg, Gg, Gs, Gs, Gs, Gs^Vl, Rb^Gvs, Gs, Gs, Rb^Gvs, Gs, Gs, Hhd, Hhd, Hhd, Gs, Gs, Rb^Gvs, Gll^Fdf, Rb^Fdw, Rb^Gvs, Rb^Gvs, Ur, Ur, Ur, Cud, Xu, Xu, Xu, Xu
Gs, Gs, Rb^Gvs, Rb^Gvs, Rb^Gvs, Rb^Gvs, Gs, Gs, Re, Re, Gs^Vh, Gs, Gs, Gs, Gs, Gs, Hhd, Hhd, Hhd, Hhd, Hhd, Hh, Gg, Ww, Ww, Wo, Wo, Ww, Ww, Gg, Gs, Gg, Gs, Rb^Gvs, Rb^Gvs, Rb^Gvs, Gs, Gs, Gs, Gs, Hhd, Hhd, Mm, Hhd, Gs, Gs, Gs, Rb^Gvs, Gs, Gs, Xu, Cud, Cud, Ur, Xu, Xu, Xu, Xu
Gs, Gs, Rb^Gvs, Rb^Gvs, Rb^Gvs, Rb^Gvs, Rb^Gvs, Gs^Vh, Gs, Gs, Rb^Gvs, Gs, Hhd, Hhd, Hhd, Gs, Gs, Hhd, Hhd, Hhd, Gs, Gs, Gg, Gg, Ww, Wo, Wo, Wo, Ww, Gg, Gll^Fmw, Gs, Gs, Gs, Gs, Gs, Gs, Gs, Gs, Hhd, Hhd^Vhh, Mm, Mm, Hhd, Hhd, Gs, Gs, Gs, Gs, Xu, Xu, Xu, Ur, Ur, Qxu, Qxu, Qxu, Qxu
Gs, Gs, Rb^Gvs, Rb^Gvs, Rb^Gvs, Rb^Gvs, Rb^Gvs, Gs, Rb^Gvs, Rb^Gvs, Rb^Gvs, Gs, Gs, Gs, Gs, Gs, Gs, Gs, Gs, Gs, Gg, Gs, Gs, Gg, Ww, Wo, Ww, Ww, Gll^Fmw, Gll^Fp, Gll^Fmw, Gll^Fmw, Gll^Fmw, Gs, Gs, Gs, Gs, Gll^Fp, Gll^Fmf, Hhd, Hhd, Mm, Mm, Mm, Hhd, Gs, Gs, Gs, Xu, Xu, Xu, Qxu, Qxu, Cud, Cud, Qxu, Qxu, Qxu
Gs, Gs, Gs, Rb^Gvs, Rb^Gvs, Rb^Gvs, Gs, Gs, Rb^Gvs, Rb^Gvs, Rd, Rd, Ce, Rd, Ce, Rd, Gs, Gs, Gs, Gs, Hhd, Gs, Gs, Gg, Gll^Fmw, Ww, Gll^Fmf, Gll^Fmf, Gs, Gll^Fmw, Gs, Gs, Gs, Gll^Fmf, Gs, Gs, Gs, Gll^Fmw, Gs, Gll^Fmf, Gs, Hhd, Hhd, Hhd, Hhd, Hhd, Gs, Xu, Xu, Xu, Xu, Qxu, Qxu, Qxu, Ur, Cud, Qxu, Qxu
Gs, Gs, Gs, Gs, Hhd, Hhd, Hhd, Hhd, Gs, Rd, Ce, Ce, 3 Ke, Ce, Ce, Ce, Gs, Gs, Hhd, Hhd, Hhd, Gs, Gg, Gg, Ww, Ww, Gll^Fmw, Gs, Gg^Ve, Gll^Fmw, Gll^Fmf, Gll^Fmw, Gs, Gll^Fmf, Gs, Gs, Gs, Gll^Fmf, Gll^Fmf, Gll^Fmw, Gs, Gs, Gs, Hhd, Gs, Hhd, Gs, Xu, Xu, Qxu, Qxu, Cud, Cud, Cud, Cud, Cud, Qxu, Qxu
Gs, Gs, Gs, Gs, Hhd, Mm, Mm, Hhd, Hhd, Gs, Rd, Ce, Ce, Ce, Rd, Ce, Gs, Gs, Gs, Hhd^Vhh, Gs, Gs, Ww, Ww, Ww^Vm, Gll^Fmw, Gll^Fp, Gs, Gs, Gll^Fmf, Gll^Fmf, Gll^Fp, Gs, Gs, Gs, Gs, Gs, Gs, Gs, Gs, Gs, Gs, Gs, Gs, Gs, Gs, Gs, Xu, Xu, Qxu, Qxu, Cud, Cud, 2 Kud, Cud, Cud, Qxu, Qxu
Gs, Gs, Hhd, Hhd, Mm, Mm, Hhd, Hhd, Gs, Gs, Gs, Rd, Gs, Gs, Gs, Gs, Gs, Gs, Gs, Gs, Gs, Gg, Ww, Hh, Hh, Gg, Gg, Gs, Gs, Gll^Fmw, Gll^Fmw, Gs, Gll^Fmw, Gll^Fmw, Gs, Gs, Gs, Gs, Gs, Gs, Gs, Gs, Gs^Vl, Gll^Fmw, Gll^Fmf, Gll^Fmw, Gs, Gs, Xu, Xu, Cud, Uu^Vu, Cud, Cud, Cud, Cud, Cud, Qxu
Hhd, Hhd, Hhd, Hhd^Vhh, Mm, Mm, Hhd, Hhd, Gs, Gs, Gs, Gs, Gs, Gs, Gs, Gs, Gs, Gs, Gs, Gs, Gs, Gll^Fmw, Ww, Ww, Gll^Fmw, Gg, Gs, Gs, Gs, Gs, Gs, Gs, Gll^Fmf, Gll^Fp, Gs, Gs, Gs, Gs, Gs, Gs, Gs, Gll^Fmf, Gll^Fmw, Gll^Fmf, Gll^Fmw, Gll^Fp, Gs, Gs, Xu, Xu, Xu, Cud, Cud, Uu^Vu, Cud, Uu^Vu, Uu^Vu, Xu
Hhd, Hhd, Mm, Mm, Hhd, Hhd, Gs, Gs, Gs, Gs, Gs, Gs, Gs, Gs, Gs, Gs, Gs, Gs, Gs, Gs, Gs, Ww, Ww, Gll^Fmf, Gs, Gs, Gs, Gs, Gs, Gs, Gs, Gs, Gs, Gll^Fmf, Gs, Gs, Gs, Gs, Gs, Gs, Gs, Gs, Gs, Gs, Gs, Gs, Gs, Gs, Gs, Xu, Xu, Xu, Xu, Xu, Xu, Xu, Xu, Xu
