Wo, Wo, Wo, Wo, Wo, Wo, Wo, Wo, Wo, Wo, Wo, Wo, Wo, Wo, Wo, Wo, Wo, Wo, Wo, Ww, Ww, Ww, Ww, Ww, Ww, Ww, Ww, Ds, Ds, Ds, Ds, Gs, Gg, Gll^Fmw, Gll^Fmw, Gll^Fmw, Gs, Gs, Gll^Fmw, Gll^Fmw, Gll^Fmw, Gll^Fmw, Gll^Fmw, Gll^Fmw, Gll^Fmw, Gll^Fmw, Gs^Fmw, Gll^Fmw, Gs^Fmw, Gll^Fmw, Gll^Fmw, Gll^Fmw, Gll^Fmw, Gll^Fmw, Gll^Fmw, Gs, Gs, Gs, Gs, Gll^Fmw, Gll^Fmw, Gll^Fmw, Gll^Fmw, Gll^Fmw, Gll^Fmw, Gll^Fmw, Gll^Fmw, Gll^Fmw, Gll^Fmw, Gll^Fmw
Wo, Wo, Wo, Wo, Wo, Wo, Wo, Wo, Wo, Wo, Wo, Wo, Wo, Wo, Wo, Wo, Wo, Ww, Ww, Ww, Ww, Ww, Ww^Vm, Ww, Ds, Ds, Ds, Ds, Ds, Ds, Gg, Gg, Gg, Gll^Fmw, Gs, Gll^Fmw, Gll^Fmw, Gll^Fp, Gll^Fmw, Gs, Gll^Fmw, Gs, Gs^Fmw, Gll^Fmw, Gs^Fmw, Gs^Fmw, Gs^Fmw, Gll^Fmw, Gll^Fmw, Gs^Fmw, Gs, Gs^Fmw, Gll^Fmw, Gll^Fmw, Gs, Gll^Fp, Gs, Gll^Fmw, Gs, Gll^Fmw, Re^Vl, Gll^Fmw, Gll^Fmw, Gll^Fmw, Gll^Fmw, Gll^Fmw, Gs, Gs^Fmw, Gll^Fmw, Gll^Fp
Wo, Wo, Wo, Wo, Wo, Wo, Wo, Wo, Wo, Wo, Wo, Wo, Wo, Wo, Wo, Wo, Ww^Vm, Ww, Ww, Ww, Ds, Ds, Ds, Ds, Ds, Ds, Ds, Ds, Ds, Ds, Gg, Gs, Gg, Gg, Gll^Fmw, Gg, Gll^Fmw, Gs^Fp, Gs^Fmw, Gs^Fmw, Gs^Fmw, Gll^Fmw, Gs, Gs^Fmw, Gll^Fmw, Gll^Fmw, Gll^Fmw, Gs^Fmw, Gs^Fmw, Gll^Fmw, Gs, Gll^Fmw, Gs^Fmw, Gll^Fp, Gll^Fmw, Gll^Fp, Gll^Fp, Gll^Fmw, Gll^Fmw, Gll^Fmw, Gll^Fmw, Re, Re, Re^Vh, Re, Gll^Fmw, Gll^Fmw, Gs^Fp, Gll^Fp, Gll^Fmw
Wo, Wo, Wo, Wo, Wo, Wo, Wo, Wo, Wo, Wo, Wo, Wo, Wo, Wo, Ww, Ww, Ww, Ww, Ww, Ww, Ds, Ds, Ds, Ds, Gg, Gg, Gg, Ds, Gg, Gg, Gg, Gg, Gs, Gs, Gg, Gs, Gs, Gs, Gll^Fp, Gs, Gs, Gs, Gll^Fmw, Gll^Fmw, Gll^Fmw, Gg^Ve, Gs, Gll^Fmw, Gll^Fmw, Gs^Fmw, Gs^Fmw, Gs^Fmw, Gs^Fmw, Gll^Fmw, Gll^Fmw, Gg^Ve, Gll^Fmw, Gll^Fmw, Ww, Gll^Fmw, Gs^Vl, Gs, Gll^Fp, Re, Gs, Re^Vl, Gll^Fmw, Gll^Fmw, Gll^Fmw, Gll^Fmw
Wo, Wo, Wo, Wo, Wo, Wo, Wo, Wo, Wo, Wo, Wo, Wo, Ww, Ww, Ww, Ww, Ww, Ww, Ww, Ww, Ds, Ds, Ds, Gg, Gg, Gg, Gg, Gg, Hh, Gg, Mm, Hh, Hh, Hh, Hh, Gs, Gll^Fmw, Gll^Fmw, Gs, Gll^Fmw, Gs, Gs^Fmw, Gll^Fmw, Gg^Ve, Gs, Gs, Gs, Gll^Fmw, Gll^Fmw, Gs, Gs, Gll^Fmw, Gs^Fmw, Gs^Fmw, Gs, Gll^Fmw, Gll^Fmw, Ww, Ww, Ww, Ww, Ww, Gll^Fmw, Re^Vh, Gs, Gll^Fmw, Gll^Fmw, Gll^Fp, Gll^Fmw, Gll^Fp
Wo, Wo, Wo, Wo, Wo, Wo, Wo, Wo, Wo, Wo, Wo, Wo, Ww, Ww, Ww, Ww, Ww, Ww, Ds, Ds, Ds, Ds, Gg, Gg, Gg, Gs, Gg, Hh, Hh, Hh, Mm, Hh, Hh, Hh, Gs, Gs, Gll^Fmw, Gll^Fmw, Gll^Fmw, Gll^Fmw, Gll^Fmw, Gs, Gll^Fmw, Gll^Fmw, Gs, Gs, Gg^Ve, Gll^Fmw, Gll^Fmw, Gs, Gll^Fmw, Gs^Fmw, Gs, Gs^Fmw, Gll^Fp, Gll^Fmw, Gll^Fmw, Ww, Ww, Ww, Ww, Ww, Gll^Fmw, Gll^Fmw, Gs, Gll^Fmw, Gll^Fmw, Gs, Gll^Fmw, Gll^Fp
Wo, Wo, Wo, Wo, Wo, Wo, Wo, Wo, Wo, Wo, Ww^Vm, Ww, Ww, Ww, Ww, Ww, Ww, Ds, Ds, Ds, Ds, Gg, Gs, Gg, Gg, Gg, Gs, Hh, Hh, Hh^Vhh, Hh, Hh, Gs, Gs, Gs, Gs, Gll^Fmw, Gs^Fmw, Gs^Fmw, Gll^Fmw, Gs^Fmw, Gll^Fmw, Gs, Gll^Fmw, Gll^Fmw, Gs, Gs^Fmw, Gll^Fmw, Gs, Gs^Fmw, Gll^Fmw, Gs, Gs, Gll^Fmw, Gll^Fmw, Gll^Fmw, Gs, Ww, Gll^Fmw, Ww, Gll^Fmw, Gll^Fmw, Gs, Re^Vl, Gll^Fmw, Gll^Fmw, Gll^Fmw, Gll^Fp, Gll^Fp, Gll^Fmw
Wo, Wo, Wo, Wo, Wo, Wo, Wo, Wo, Wo, Wo, Ww, Ww, Ww, Ww, Ww, Ww, Ww, Ds, Gg, Gg, Gg, Gg, Gg, Gg, Gs^Fmw, Gll^Fmw, Gs, Hh, Hh, Hh, Gs, Gs, Gs, Gs, Gs, Gll^Fmw, Gs, Gll^Fmw, Gs, Gll^Fmw, Gs^Fmw, Gll^Fmw, Gll^Fmw, Gll^Fmw, Gll^Fmw, Gs^Fmw, Gs, Gs^Fmw, Gs, Gs, Gs^Fmw, Gs^Fmw, Gll^Fmw, Gll^Fmw, Gll^Fmw, Gll^Fmw, Gs, Gs, Gll^Fmw, Gll^Fmw, Gll^Fmw, Gll^Fp, Gll^Fmw, Gs, Gll^Fp, Gll^Fmw, Gll^Fmw, Gll^Fmw, Gll^Fmf, Gll^Fmw
Wo, Wo, Wo, Wo, Wo, Wo, Wo, Wo, Wo, Ww, Ww, Ww, Ww, Ww, Ww, Ww, Ww^Vm, Ds, Gs, Gs, Gs, Gs, Gg, Gs, Gs, Gll^Fp, Gll^Fmw, Gs, Gs, Gs, Gs, Gs, Gs, Gs, Gs, Gll^Fp, Gs, Gs, Gll^Fp, Gll^Fmw, Gll^Fmw, Gll^Fmw, Gs, Gs^Fmw, Gs, Gll^Fmw, Gs^Fmw, Gs, Gll^Fmw, Gs^Fmw, Gll^Fmw, Gll^Fmw, Gll^Fmw, Gs^Fmw, Gs, Gs, Gll^Fmw, Gll^Fp, Gll^Fmw, Gll^Fmf, Gs, Gll^Fmw, Re, Re, Re, Gs, Gll^Fmw, Gll^Fmw, Gll^Fmw, Gll^Fmw
Wo, Wo, Wo, Wo, Wo, Wo, Ww, Wo, Ww, Ww, Ww, Ww, Ww, Ww, Ds, Ds, Ds, Ds, Gs, Gg^Vct, Re^Vct, Gs, Gs, Gs, Gs, Gs^Fmw, Gll^Fmw, Gs^Fmw, Gs^Fmw, Gs, Gs, Gs, Gs, Gs, Gs, Gll^Fmw, Gs^Vl, Gll^Fmw, Gll^Fmw, Gll^Fmw, Gll^Fmw, Gll^Fmw, Gll^Fmw, Gll^Fmw, Gs, Gll^Fmw, Re, Gll^Fmw, Re, Gs, Re, Gll^Fmw, Re, Gll^Fmw, Gs, Gll^Fmw, Re, Gll^Fmw, Re, Re, Re, Re, Re, Re, Re, Re, Re, Re, Re, Re
Wo, Wo, Wo, Wo, Ww, Ww, Ww, Ww, Ww, Ww, Ww, Ww, Ds, Ds, Gs^Vct, Ds, Ce, Ce, Ce, Gg, Gs, Gs, Gs, Gs, Gs, Gs, Gs, Gll^Fmw, Gs, Gs^Fmw, Re, Re, Re, Re, Re, Re, Re, Re, Re, Re, Re, Re, Re, Re, Re, Re, Re, Re, Re, Re, Re, Re, Re, Re, Re, Re, Re, Re, Re, Re, Gs, Re, Gll^Fmw, Gll^Fmw, Gs, Re, Gs, Gll^Fmw, Gs, Gs
Ww, Wo, Ww, Ww, Ww, Ww, Ww, Ww, Ww, Ww, Ds, Ds, Gg, Gs^Vct, Ce, Ce, 1 Ke, Ce, Ce, Gs, Gs, Re^Vct, Gs, Gs, Gs, Gs, Gs, Gs, Re, Re, Re, Re, Re, Re, Re, Re, Re, Re, Re, Re, Gll^Fmw, Re, Gs^Fmw, Re, Gll^Fmw, Re, Gll^Fmw, Gll^Fmw, Gll^Fmw, Gll^Fmw, Gll^Fmw, Re, Gll^Fmw, Re, Gs, Gll^Fmw, Gll^Fp, Gll^Fmw, Gll^Fmw, Gll^Fmw, Gll^Fp, Gg^Ve, Gll^Fmw, Gll^Fp, Gll^Fmw, Gll^Fmw, Gs, Gll^Fp, Gll^Fmw, Gs
Ww, Ww, Ww, Ww, Ww, Ww, Ww, Ww, Ww, Ds, Gg, Gg, Rb^Gvs, Gs, Ce, Ce, Ce, Ce, Gs, Gs, Re^Vct, Gs, Gs, Gs, Re, Gs, Re, Re, Re, Re, Gs, Gs, Gs, Gs, Gs, Gs, Gs, Re, Re, Re, Re, Gs^Fmw, Gs, Gll^Fmw, Gll^Fmw, Gs, Gll^Fmw, Gs^Fmw, Gll^Fmw, Gs^Fmw, Gs^Fmw, Gs, Gll^Fmw, Gll^Fmw, Gll^Fmw, Gll^Fmw, Gs, Gs^Fmw, Gs^Fmw, Gll^Fmw, Gll^Fmw, Gll^Fmw, Gs, Gll^Fmw, Gll^Fmw, Gs, Gll^Fmw, Gll^Fp, Gs, Gll^Fmw
Ww, Ww, Ww, Ww, Ww, Ww, Ds, Ww^Vm, Ds, Ds, Rb^Gvs, Rb^Gvs, Rb^Gvs, Rb^Gvs, Gg, Ce, Gs, Gs, Re^Vct, Gs, Gs, Gs, Re, Re, Re, Re, Re, Re, Gs, Gs, Gs, Gs, Gs, Gs, Gs, Gs, Gll^Fmw, Gll^Fmw, Gll^Fmw, Re, Re, Re, Re, Gll^Fmw, Gs^Fmw, Gs, Gs^Fmw, Gs, Gs^Fmw, Gs, Gs, Gs, Gs^Fmw, Gll^Fmw, Gs, Gll^Fp, Gs^Fmw, Gs^Fmw, Gll^Fmw, Gs, Gll^Fmw, Gll^Fmw, Hhd^Fmw, Gll^Fmw, Hhd^Fmw, Gll^Fmw, Gll^Fmw, Gll^Fmw, Gll^Fmw, Gs
Ww, Ww, Ww, Ww, Ds, Ds, Gg, Gg, Gg, Rb^Gvs, Rb^Gvs, Rb^Gvs, Rb^Gvs, Rb^Gvs, Gs, Gs, Re^Vct, Gs, Gs, Gs, Gs, Gs, Re, Re, Re, Gs^Vl, Gs, Gs, Gs, Gs, Gs, Gs, Gs, Gs, Gs, Gs, Gs, Gs^Fmw, Gll^Fmw, Gs^Fmw, Gs, Re, Re, Re, Gs, Gs^Fmw, Gll^Fmw, Gll^Fmw, Gll^Fmw, Gll^Fmw, Gs, Gll^Fmw, Gll^Fmw, Gll^Fp, Gll^Fmw, Gll, Gs, Gs, Gll^Fmw, Gll^Fmw, Gs^Fmw, Gll^Fmw, Hhd, Hhd, Mm, Hhd, Gll^Fmw, Gll^Fmw, Gll^Fmf, Gll^Fmw
Ww, Ww, Ds, Ds, Gg, Gg, Rr, Rr^Vhc, Gs, Gg, Ce, Rb^Gvs, Gs, Gs, Gs, Gs, Gs, Gs, Gs, Gs, Re, Re, Re, Re, Gs, Gs, Gs, Gs, Gs, Hh, Hh, Gs, Hh, Gs, Hhd^Fmw, Hhd, Gs^Fmw, Gs^Fmw, Gs, Gs, Gll^Fmw, Gs^Fmw, Re, Re, Gs, Gs, Gg^Ve, Gs, Gs, Gs, Gll^Fmw, Gs, Gll^Fmw, Gll^Fmw, Hhd, Gll^Fmw, Hhd, Gll^Fp, Gs, Gs^Fmw, Gll^Fmw, Hhd^Fmw, Hhd, Mm, Hhd, Mm, Gll^Fmw, Gll^Fmw, Gll^Fmw, Gll^Fmw
Ds, Ds, Rb^Gvs, Gs^Vh, Gs, Rr, Rr, Re, Re, Re^Vh, Ce, Gs, Gg, Gs, Gs, Gg, Gs, Gs, Re, Re, Re, Re, Gs, Gs, Gs, Gs, Gs, Hh, Hh, Hh, Hhd^Vhh, Hh, Gs, Hhd, Hhd^Fmw, Hhd^Fp, Hhd^Fmw, Gs^Fmw, Gll^Fmw, Gll^Fmw, Gs, Gs^Fmw, Re, Re, Gs, Gll^Fmw, Gs^Fmw, Gll^Fmw, Gs^Fmw, Gll^Fmw, Gs, Gs, Gll^Fmw, Hhd, Hhd^Fmw, Mm, Hhd^Fmw, Hhd^Fmw, Gll^Fmw, Gll^Fmw, Gll^Fmw, Gs, Hhd, Hhd, Gll^Fmw, Gll^Fmw, Gs, Gs, Gll^Fp, Gs
Rb^Gvs, Rb^Gvs, Rb^Gvs, Rb^Gvs, Re^Vh, Gg, Re, Rr, Rr, Ket, Rr, Gs, Gs, Gs, Gs, Gs, Gs, Gs, Re, Re, Gs, Gs, Gs, Gs, Gs, Hh, Hh, Hh, Hh, Hh, Hh, Hhd, Mm, Hhd, Hhd^Fp, Hhd, Gs^Fmw, Gs^Fmw, Gll^Fmw, Gs^Fmw, Gs, Gs, Re, Re, Gll^Fmw, Gll^Fmw, Gs^Fmw, Gs, Gll^Fmw, Gs^Fmw, Gs, Gll^Fmw, Gll^Fmw, Hhd^Fmw, Gll^Fp, Gll^Fmw, Gll^Fmw, Gll^Fmw, Gg^Ve, Gll^Fmw, Gs, Gs, Gll^Fmw, Gll^Fmw, Gs, Gll^Fmw, Gs, Gll^Fmw, Gll^Fmw, Gll^Fmw
Rb^Gvs, Rb^Gvs, Rb^Gvs, Rb^Gvs, Ce, Gs, Ce, Ket, Re, Rr, Rr, Rr, Re, Gs, Re, Re, Re, Re, Re, Re, Gs, Gs, Gs, Hh, Hh, Hh, Hh, Gs, Hh, Gs, Hhd, Mm, Mm, Hhd^Fp, Hhd^Fmw, Hhd^Fmw, Gs, Gs, Gs, Gll^Fmw, Gll^Fmw, Gs^Fmw, Re, Re, Gll^Fmw, Gs, Gs, Gll^Fmw, Gs, Gs, Gll^Fmw, Gll^Fmw, Gs, Gll^Fmw, Gll^Fmw, Gs, Gll^Fmw, Gll^Fmw, Gll^Fp, Gll^Fmw, Gs, Gs, Gs, Gll^Fmw, Gs, Gll^Fp, Gll^Fmw, Gg^Ve, Gll^Fmw, Gll^Fmw
Rb^Gvs, Rb^Gvs, Gg, Gs, Gs, Ce, Gg, Gs, Gs, Gs, Gs, Re, Re, Re, Re, Re, Gs^Vl, Gs, Gs, Gs, Gs, Gs, Gs, Hh, Hhd, Hh, Hh^Vhh, Hhd, Hhd, Hh, Hh, Hhd, Hhd, Hhd, Hhd, Hhd^Fmw, Hhd, Gs, Gs, Gll^Fmw, Gs, Gs, Re, Re, Gs, Gs, Gs^Fmw, Gll^Fmw, Gs, Gs^Fmw, Gs, Gll^Fmw, Gll^Fmw, Gll^Fp, Gs, Gll^Fmw, Gll^Fmw, Gll^Fmw, Gs, Gll^Fp, Gll^Fmw, Gs, Gll^Fmw, Gll^Fmw, Gs, Gs, Gs, Gll^Fmw, Gll^Fp, Gll^Fp
Gs, Gs, Rb^Gvs, Rb^Gvs, Gs, Gs, Gs, Gg, Gs, Gs, Re, Re, Re, Re, Re, Re, Gs, Gs, Gs, Gs, Hh, Gs, Hh, Hh, Hhd, Hhd, Mm, Mm, Mm, Mm, Hhd, Gs, Hhd, Gs, Hhd, Hhd, Gs, Gs, Gs, Gs, Gs, Gs, Re, Re, Gs, Gs^Fmw, Gll^Fmw, Gll^Fmw, Gs, Gll^Fmw, Gs, Gs^Fmw, Gs^Fmw, Gs, Gll^Fmw, Gll^Fp, Gll^Fmw, Gs, Gll^Fmw, Gs^Fmw, Gs^Fmw, Gs, Gll^Fp, Gll^Fmw, Gll^Fmw, Gs, Gll^Fmw, Gll^Fmw, Gll^Fmw, Gll^Fmw
Gs, Rb^Gvs, Rb^Gvs, Rb^Gvs, Gs, Gg, Gs, Gs, Gs, Re, Re, Re, Gs, Gs, Gs, Gs, Gs, Gs, Gs, Hh, Hh, Hh, Hh, Hhd, Mm, Mm, Mm, Mm, Mm, Mm, Hhd, Hh^Vhh, Hhd, Hhd, Hhd, Gs, Gs, Gs, Rb^Gvs, Rb^Gvs, Rb^Fdw, Gs, Re, Re, Gs, Gs, Gs, Gs, Gs, Gll^Fmw, Gs, Gs, Gs^Fmw, Gll^Fmw, Gs^Fmw, Gs^Fmw, Gs, Gll^Fmw, Gs, Gs, Gll^Fmw, Gll^Fmw, Re^Vl, Gll^Fmw, Gll^Fmw, Gll^Fmw, Gs, Gll^Fmw, Gll^Fmw, Gs
Gs, Rb^Gvs, Gs, Gs, Gs, Gs, Gs, Gs, Re, Re, Re, Re, Gs, Gs, Gs, Gs, Gs, Gs, Hh, Gs, Hh, Gs, Hh, Hhd, Mm, Mm, Mm, Mm, Mm, Hhd, Hhd, Hhd, Gs, Hhd, Hhd, Hhd, Rb^Gvs, Rb^Gvs, Rb^Fdw, Gll^Fdf, Rb^Gvs, Rb^Gvs, Re, Re, Gs, Gs, Gs, Gs, Gs, Gs, Gs, Gll^Fmw, Gs, Gs, Gs^Fmw, Gs, Gs^Fmw, Gs, Gll^Fmw, Gll^Fmw, Re^Vl, Re, Re, Gll^Fmw, Gll^Fmw, Gll^Fmw, Gll^Fmw, Gll^Fmw, Gs, Gs
Gg, Gs, Gs, Gs, Gs, Gs, Gs, Re, Re, Re, Gs, Gs, Gs, Gs, Gs, Gs, Hh, Hh, Gs, Hh, Hhd, Hh, Mm, Mm, Mm, Mm, Mm, Chr, Chr, Mm, Hhd, Gs, Hhd, Hhd, Hhd, Gs, Gs, Rb^Fdw, Rb^Gvs, Rb^Gvs, Re, Re, Ce, Re, Gs, Gs, Gs, Gs, Rb^Gvs, Rb^Gvs, Rb^Fdw, Gs, Gs, Gs, Gs, Gs, Gs, Gs, Gs, Gs, Gs, Gll^Fmw, Re, Re^Vl, Gll^Fmw, Gs, Gll^Fmw, Gll^Fmw, Gll^Fp, Gs
Gs, Gs, Gs, Gs, Gs, Gs, Re, Re, Re, Gs^Vl, Gs, Gs, Gs, Gs, Gll^Fmw, Gs, Gs, Hh, Hhd, Hh, Hhd, Hhd, Mm, Mm, Mm, Mm, Hhd^Vhc, Khr, Chr, Chr, Hhd, Hhd, Hhd, Gs, Gs, Gs, Gs, Gs, Rb^Fdw, Gs, Ce, Re^Vh, Re, Ce, 2 Ket, Gs, Rb^Gvs, Rb^Gvs, Rb^Fdw, Rb^Fdw, Rb^Gvs, Rb^Gvs, Rb^Fdw, Gs, Gs, Gs, Rb^Gvs, Gs, Gs, Gs, Gs, Re, Gs, Gll^Fmw, Gs, Gll^Fmw, Gs, Gll^Fmw, Gs, Gll^Fmw
Gs, Gs, Gs, Gs, Re, Re, Re, Re, Gs, Gs, Gs, Gs, Gll^Fmw, Gll^Fp, Gll^Fmf, Gs, Hh^Fmw, Hh, Hhd^Fmw, Hhd, Mm, Mm, Mm, Mm, Mm, Mm, Mm, Chr, Gs, Hhd, Gs, Hhd, Hhd, Gs, Gs, Gs, Rb^Fdw, Rb^Fdw, Rb^Gvs, Gs, Gs, Gs, Re, Re, Ce, Gs, Rb^Fdw, Rb^Fdw, Rb^Gvs, Rb^Gvs, Rb^Fdw, Rb^Fdw, Gs, Gs, Rb^Gvs, Rb^Gvs, Rb^Fdw, Rb^Fdw, Rb^Gvs, Gs, Gs, Re, Gs, Gs, Gs, Gs, Gll^Fmw, Gs, Gll^Fmw, Gs
Gs, Gs, Gs, Re, Re, Re, Re, Gs, Gs, Gs, Gs, Gll^Fmw, Gll^Fmf, Gll^Fmw, Gll^Fmf, Gs^Fmw, Gll^Fmw, Gll^Fmw, Hh^Fmf, Hhd^Fmw, Mm^Vhh, Mm, Mm, Mm, Hhd, Hh, Hhd, Gs, Hhd, Hhd, Hhd, Hhd, Gs, Gs, Gs, Gs, Rb^Gvs, Rb^Gvs, Rb^Gvs, Gs^Vh, Gs, Rr^Vhc, Gs, Re^Vh, Ce, Gs, Rb^Gvs, Rb^Gvs, Gll^Fdf, Rb^Fdw, Gs, Gd^Vhr, Rb^Gvs, Rb^Gvs, Rb^Fdw, Rb^Fdw, Rb^Gvs, Rb^Gvs, Rb^Fdw, Rb^Fdw, Rb^Gvs, Gs, Gs, Gs, Gs, Gs, Gll^Fp, Gs, Gll^Fmw, Gll^Fmw
Gs, Gs, Re, Re, Re, Re, Gs, Gs, Gs, Gs, Gll^Fmw, Gll^Fmw, Gs, Gll^Fmw, Hh, Hh, Hhd, Hh, Hh, Hh, Mm, Mm, Hhd, Hhd, Hhd, Hhd, Gs, Hhd, Hhd, Hhd, Gs, Hhd, Gs, Gs, Gs, Gs, Rb^Gvs, Rb^Gvs, Gll^Fdf, Gs, Gs, Ce, Ce, Re, Gs, Gs, Gs, Rb^Fdw, Gs, Gs, Rb^Gvs, Rb^Gvs, Rb^Fdw, Rb^Fdw, Rb^Gvs, Rb^Gvs, Rb^Fdw, Rb^Fdw, Rb^Gvs, Rb^Gvs, Gs, Gs, Gs, Hh, Gs, Gs, Gg, Gs, Gs, Gs
Re, Re, Re, Re, Gs, Re, Re, Re, Re, Gs, Gs, Gs, Gs, Gs, Hh, Hh, Hh, Gs, Hhd, Hhd, Hhd, Hhd, Hh, Gs, Hh, Hh, Hh, Hhd, Hhd, Gs, Gs, Gs, Gs, Hhd, Gs, Gs, Rb^Fdw, Rb^Fdw, Rb^Gvs, Rb^Gvs, Rb^Gvs, Gs, Gs, Gs, Rb^Gvs, Rb^Gvs, Rb^Fdw, Gs, Gs, Rb^Gvs, Rb^Fdw, Rb^Fdw, Rb^Gvs, Rb^Gvs, Rb^Fdw, Rb^Fdw, Rb^Gvs, Rb^Gvs, Gs, Gs, Gs, Gs, Gs, Gs, Hh, Hh, Gg, Hh, Hh, Gs
Re, Re, Gs, Gs, Gs, Gs, Gs, Gs, Re, Gs, Gs, Gs, Gs, Hh, Hh, Gs, Gs, Hhd, Hh, Hhd^Vhh, Hhd, Hhd, Hh, Hh, Wo, Hh, Wo, Hh, Gg, Gs, Gs, Gg, Gs, Gs, Gs, Gs, Rb^Gvs, Rb^Gvs, Rb^Gvs, Rb^Gvs, Gs, Gs, Gs, Rb^Gvs, Rb^Fdw, Rb^Fdw, Rb^Gvs, Rb^Gvs, Rb^Fdw, Gs, Gs, Rb^Gvs, Rb^Fdw, Rb^Fdw, Rb^Gvs, Rb^Gvs, Gs, Gs, Gg, Gs, Gs, Hh, Hh^Vhh, Hh, Mm, Mm, Mm, Hh, Mm, Hh
Gs, Gs, Gs, Gs, Rb^Gvs, Gs, Gs^Vh, Gs, Re, Re, Gs, Gs^Vh, Gs, Hh, Hh, Hh, Hhd, Hhd, Gs, Hhd, Hhd, Gs, Hh, Hh, Wo, Wo, Wo, Ww, Gg, Gg, Gs, Gs, Gs, Gs^Vl, Rb^Gvs, Gs, Gs, Rb^Gvs, Gs, Gs, Hhd, Hhd, Hhd, Gs, Gs, Rb^Gvs, Gll^Fdf, Rb^Fdw, Rb^Gvs, Rb^Gvs, Gs, Gd^Vhr, Gs, Rb^Gvs, Gs, Gs, Gg, Gs, Gg, Gg, Gg, Hh, Hh, Gg, Mm, Mm, Ss, Ss, Ss^Vhs, Mm
Gs, Gs, Rb^Gvs, Rb^Gvs, Rb^Gvs, Rb^Gvs, Gs, Gs, Re, Re, Gs^Vh, Gs, Gs, Gs, Gs, Gs, Hhd, Mm, Hhd, Hhd, Hhd, Hh, Gg, Ww, Ww, Wo, Wo, Ww, Ww, Gg, Gs, Gg, Gs, Rb^Gvs, Rb^Gvs, Rb^Gvs, Gs, Gs, Gs, Gs, Hhd, Hhd, Mm, Hhd, Gs, Gs, Gs, Rb^Gvs, Gs, Gs, Rb^Gvs, Rb^Gvs, Rb^Fdw, Gs, Gs, Gs, Gs, Gs, Gs, Hh, Gs, Gg, Hh, Hh, Mm, Mm, Ss, Ss, Ss, Ss
Gs, Gs, Rb^Gvs, Rb^Gvs, Rb^Gvs, Rb^Gvs, Rb^Gvs, Gs^Vh, Gs, Gs, Rb^Gvs, Gs, Hhd, Hhd, Hhd, Gs, Mm, Mm, Hhd, Hhd, Gs, Gs, Gg, Gg, Ww, Wo, Wo, Wo, Ww, Gg, Gll^Fmw, Gs, Gs, Gs, Gs, Gs, Re, Gs, Gs, Hhd, Hhd^Vhh, Mm, Mm, Hhd, Hhd, Gs, Gs, Gs, Rb^Gvs, Rb^Gvs, Rb^Fdw, Rb^Fdw, Rb^Gvs, Rb^Gvs, Gg, Gs, Gg, Gs, Gg, Gs, Gs, Gg, Hh, Hh, Ww, Ww, Mm, Mm, Ss, Ss
Gs, Gs, Rb^Gvs, Rb^Gvs, Rb^Gvs, Rb^Gvs, Rb^Gvs, Gs, Rb^Gvs, Rb^Gvs, Rb^Gvs, Gs, Gs, Gs, Gs, Hhd, Mm, Hhd, Gs, Gs, Gg, Gs, Gs, Gg, Ww, Wo, Ww, Ww, Gll^Fmw, Gg^Fp, Gg^Fmw, Gll^Fmw, Gll^Fmw, Gs, Gs, Gs, Re, Gs, Gll^Fmf, Hhd, Hhd, Mm, Mm, Mm, Hhd, Gd^Vhr, Gs, Rb^Gvs, Rb^Fdw, Rb^Fdw, Rb^Gvs, Rb^Gvs, Gs, Gs, Gg, Gg, Gg, Gg, Ww, Gg, Gg, Hh, Hh, Ww, Mm, Hh, Gg, Mm, Mm, Ss
Gs, Gs, Gs, Rb^Gvs, Rb^Gvs, Rb^Gvs, Gs, Gs, Rb^Gvs, Rb^Gvs, Rd, Rd, Ce, Rd, Ce, Rd, Hhd, Hhd, Gs, Gs, Hhd, Gs, Gs, Gg, Gll^Fmw, Ww, Gll^Fmf, Gll^Fmf, Gs, Gg^Fmw, Gs, Gs, Gs, Gll^Fmf, Gs, Gs, Re, Gll^Fmw, Gs, Gll^Fmf, Gs, Hhd, Hhd, Hhd, Hhd, Hhd, Gg, Gs, Gs, Rb^Gvs, Gs, Gg, Gs, Gs, Gg, Ww, Ww, Ww, Ww, Ww, Ww^Vm, Gg, Gg, Ww, Hh, Hh, Gg, Mm, Mm, Hhd
Gs, Gs, Gs, Gs, Hhd, Hhd, Hhd, Hhd, Gs, Rd, Ce, Ce, 4 Ke, Ce, Ce, Ce, Gs, Gs, Hhd, Hhd, Hhd, Gs, Gg, Gg, Ww, Ww, Gll^Fmw, Gg, Gg^Ve, Gll^Fmw, Gg^Fmf, Gll^Fmw, Gs, Gll^Fmf, Gs, Gs, Gs, Gll^Fmf, Gll^Fmf, Gll^Fmw, Gs, Gs, Gs, Hhd, Gs, Hhd, Gs, Gs, Gg, Gs, Gs, Gs, Gg, Gg, Ww, Ww, Ww, Ww, Wo, Ww, Ww, Ww, Ww, Ww, Gg, Hh, Hh, Hh, Hh, Mm
Gs, Gs, Gs, Gs, Hhd, Mm, Mm, Hhd, Mm, Hhd, Rd, Ce, Ce, Ce, Rd, Ce, Gs, Gs, Hhd, Hhd^Vhh, Gs, Gs, Ww, Ww, Ww^Vm, Gll^Fmw, Gll^Fp, Gg, Gs, Gll^Fmf, Gll^Fmf, Gll^Fp, Gs, Gs, Gs, Gs, Re, Gs, Gs, Gs, Gs, Gs, Gs, Gs, Gs, Gs, Gg, Gs, Gs, Gs, Gs, Gg, Ww, Ww^Vm, Ww, Ww, Wo, Wo, Wo, Ww, Wo, Ww, Ww, Gg, Gg, Gs, Gg, Gg, Hh, Hh
Gs, Gs, Gs, Hhd, Mm, Mm, Hhd, Hhd, Gs, Hhd, Hhd, Hhd, Hhd, Hhd, Hhd, Gs, Gs, Hhd, Hhd, Mm, Gg, Gg, Ww, Hh, Hh, Gg, Gg, Gg, Gs, Gll^Fmw, Gll^Fmw, Gs, Gll^Fmw, Gll^Fmw, Gs, Gs, Re, Gs, Gs, Gs, Gs, Gs, Gd^Vhr, Gll^Fmw, Gll^Fmf, Gg^Fmw, Gs, Gs, Gg, Gd^Vhr, Gs, Gg, Ww, Ww, Ww, Ww, Wo, Wo, Wo, Wo, Wo, Ww, Ww, Ww, Gg, Gs, Gs, Gg, Gs, Hh
Hhd, Hhd, Hhd, Hhd^Vhh, Mm, Mm, Hhd, Hhd, Gs, Hhd, Hhd, Mm, Mm, Mm, Hhd, Hhd, Gs, Gs, Hhd, Hhd, Gg, Gll^Fmw, Ww, Ww, Gll^Fmw, Gg, Gg, Gs, Gs, Gs, Gs, Gs, Gll^Fmf, Gll^Fp, Gs, Gs, Gll^Fmf, Re, Gs, Gs, Gs, Gll^Fmf, Gll^Fmw, Gll^Fmf, Gll^Fmw, Gll^Fp, Gs, Gs, Gg, Gs, Ww, Ww, Ww, Ww, Ww, Ww, Chw, Khw, Chw, Ww, Ww, Ww^Vm, Gg, Gg, Gs, Gs, Gs, Gg, Gs, Gs
Hhd, Hhd, Mm, Mm, Hhd, Hhd, Gs, Gs, Rb^Gvs, Gs, Gs, Hhd, Hhd, Hhd, Rb^Gvs, Rb^Gvs, Rb^Gvs, Gs, Gg, Gs, Gg, Ww, Ww, Gll^Fmf, Gs, Gs, Gll^Fmf, Gll^Fmf, Gll^Fmf, Gs, Gs, Gs, Gs, Gll^Fmf, Gs, Gll^Fmf, Gs, Re, Gs, Gs, Gs, Gs, Gs, Gs, Gs, Gs, Gs, Gs, Gs, Gs, Ww, Gg, Gg, Ww^Vm, Ww, Ww, Ww, Chw, Ww, Chw, Ww, Ww, Gg, Gs, Gs, Gg, Gg, Gs, Hh, Gs
Mm, Mm, Mm, Hhd, Gs, Hhd, Gs, Rb^Gvs, Rb^Gvs, Rb^Gvs, Gs, Gs, Rb^Gvs, Rb^Gvs, Rb^Gvs, Rb^Gvs, Rb^Gvs, Rb^Gvs, Rb^Gvs, Gs, Gg, Gg, Ww, Gg, Gs, Gs, Gg^Fmf, Gg^Fmf, Gll^Fmf, Gs, Gs, Gs, Gs, Gs, Gs, Gll^Fmf, Gs, Re, Gs, Gll^Fmf, Gs, Gs, Gs, Gs, Gg, Gs, Gs, Gg, Gg, Gg, Gg, Gg, Gg, Gg, Gg, Gg, Gg, Ww^Bw|r, Ww, Ww, Gg, Ww, Gg, Gs, Gg, Gg, Gs, Hh, Hh, Hh
Hhd, Mm, Gs, Hhd, Hhd, Gs, Gs, Gs, Gs, Gs, Gs, Rb^Gvs, Rb^Gvs, Rb^Gvs, Gs^Vl, Rb^Gvs, Rb^Gvs, Rb^Gvs, Rb^Gvs, Rb^Gvs, Gg, Ww, Ww, Gg, Gll^Fmf, Gg, Gg, Gs, Gs, Gs, Gs, Gll^Fmf, Gs, Gll^Fmf, Gll^Fmf, Gs, Re, Gs, Gll^Fmf, Gll^Fmf, Gll^Fmf, Gs, Gll^Fmf, Gll^Fmf, Gs, Gs, Gs, Gs, Gs, Gs, Gll^Fmf, Gs, Gg, Gs, Gg, Gs, Gs, Gg, Gg, Gg, Gg, Gg, Gg, Gs, Hhd^Vhhr, Hh, Gs, Hh, Hh, Gs
Hhd, Hhd, Mm, Hhd, Gs, Gs, Gs, Gs, Hhd, Hhd, Hhd, Gs, Gs, Rb^Gvs, Rb^Gvs, Gs, Gs, Rb^Gvs, Gs, Gg, Ww, Ww, Ww, Gg, Gs, Gg, Gs, Gs, Gs, Gll^Fmf, Gll^Fmf, Gs, Gll^Fmf, Gs, Gll^Fmf, Re, Gll^Fmf, Gd^Vhr, Gll^Fmf, Gs, Gs, Gs, Gs, Gs, Gg, Gs^Fmf, Gs, Gs, Gll^Fmf, Gg, Gs, Gs, Gs, Gs, Gs, Gs, Hh, Gg, Hh, Gs, Gs, Gs, Hh, Hh, Hh, Hh, Gs, Gs, Hh, Hh
Hhd, Hhd, Hhd, Gs, Gs, Gs, Gs, Gs, Hhd, Hhd, Hhd, Hhd, Hhd, Gs, Gs, Rb^Gvs, Gg, Gs, Gg, Gg, Ww^Vm, Ww, Gg, Gll^Fmf, Gs, Gll^Fmf, Gg^Fmf, Gs, Gll^Fmf, Gll^Fmf, Gs, Gd^Vhr, Re, Re, Re, Re, Gs, Gll^Fmf, Gs, Gs, Gs, Gs, Gs, Gs, Gs, Gs, Gs, Gs, Gs, Gs, Gs, Ss, Ss, Ss, Gg, Gs, Gs, Hh, Hh, Hh, Gs, Gg, Gs, Gs, Hh, Gs, Gs, Gs, Gs, Gs
Hhd, Gs, Gs, Gs, Gs, Gs, Rb^Gvs, Rb^Gvs, Rb^Gvs, Gs, Gs, Gs, Gs, Hhd, Hhd, Hhd, Hhd, Gs, Gs, Gg, Ww, Ww, Ww, Gll^Fmf, Gll^Fmf, Gll^Fmf, Gll^Fmf, Gd^Vhr, Re, Gll^Fmf, Re, Re, Gll^Fmf, Gll^Fmf, Re, Gd^Vhr, Gs, Gll^Fmf, Gll^Fmf, Gll^Fmf, Gll^Fmf, Gll^Fmf, Gll^Fmf, Gs, Gs, Gll^Fmf, Ss, Gs, Gs, Gll^Fmf, Gll^Fmf, Ss, Ss, Ss^Vhs, Gs, Gs, Gs, Hh, Hh, Gd^Vhr, Gs, Gs, Gs, Gs, Gs, Gs, Gs, Gs^Fmw, Gll^Fmf, Gs
Hhd, Hhd, Gs, Gs, Rb^Gvs, Rb^Gvs, Rb^Gvs, Rb^Gvs, Gs, Gs, Gs, Gs, Gs, Gs, Gs, Gs, Gs, Gs, Gg, Gll^Fmf, Ww, Wo, Ww, Gg, Gg, Gs, Gg^Fmf, Gll^Fmf, Re, Re, Re, Re, Re, Gs, Gd^Vhr, Gll^Fmf, Gs, Gll^Fmf, Gs, Gll^Fmf, Gs, Ss, Gs, Gll^Fmf, Gs, Gs, Gs, Gs, Gll^Fmf, Ss, Gs, Ss, Ss, Ss, Gs, Hh, Gs, Gs, Ss, Ss, Gd^Vhr, Gs, Gs, Gs, Gs, Gs, Gs, Gs, Gs, Gll^Fmw
Gs, Gs, Gs, Gs, Gs, Rb^Gvs, Gs, Gs, Gd^Vhr, Gs, Gs, Gs, Gs, Gs, Gll^Fmf, Gll^Fmf, Gll^Fmf, Gll^Fmf, Gll^Fmf, Gll^Fmf, Ww, Wo, Ww, Gg, Gs, Gll^Fmf, Gs, Re, Gs, Gll^Fmf, Gll^Fmf, Gd^Vhr, Gs^Fmf, Gll^Fmf, Gs^Fmf, Gll^Fmf, Gll^Fmf, Gll^Fmf, Gll^Fmf, Gll^Fmf, Gs^Fmf, Ss, Gs, Gs, Ss, Gs, Gll^Fmf, Gs, Ss, Gs, Ss, Ss, Ss, Gs, Gg, Gs, Gg, Gs, Ss, Ss, Gs, Gs, Gs, Ur, Ur, Gs, Gs, Gs, Gs, Xu
Gs, Gs, Gs, Gs, Gd^Vhr, Gs, Rp^Vhcr, Gs, Gs, Gs, Rr, Gs, Gs, Gs, Gs, Gg, Gg, Gll^Fmf, Gg, Gll^Fmf, Ww, Ww, Gll^Fmf, Gll^Fmf, Gll^Fmf, Gll^Fmf, Gs, Re, Gs, Gs, Gll^Fmf, Gs^Fmf, Gs^Fmf, Gll^Fmf, Gs, Gs, Gll^Fmf, Gs^Fmf, Gll^Fmf, Gs^Fmf, Gll^Fmf, Gs, Ss, Ss^Vhs, Ss, Ss, Ss, Ss, Ss, Gs, Gs, Gg, Gg, Gs, Gs, Gll^Fmf, Gll^Fmf, Gll^Fmf, Gg, Gg, Gs, Gg, Ur, Ur, Ur, Cud, Xu, Xu, Xu, Xu
Gs, Gs, Gs, Gs, Gs, Gs, Rr, Gs, Rr, Rr, Ch, Chr, Chr, Gs, Gs, Gd^Vhr, Gs, Gll^Fmf, Gg, Ww, Ww, Ww, Gll^Fmf, Gll^Fmf, Re, Re, Gll^Fmf, Gs, Gs^Fmf, Gs, Gs, Gs^Fmf, Gs, Gs, Gs^Fmf, Gs, Gs, Gs^Fmf, Gll^Fmf, Gs, Gll^Fmf, Gs, Gs, Ss, Gg^Fmf, Ss, Gs, Gs, Gg^Fmf, Gs, Gg^Fmf, Gg^Fmf, Gll^Fmf, Gs, Ss^Bw|, Ss, Ss, Gll^Fmf, Ss, Gs, Ss, Gg, Xu, Cud, Cud, Ur, Xu, Xu, Xu, Xu
Gs, Gs, Re, Gs, Re, Rr, Rr, Rp^Vhcr, Rr, Rr, Chr, Khr, Chr, Re, Re, Gg, Re, Gg, Ww, Ww^Bw\, Ww^Bw\, Ww, Gs, Gs, Gll^Fmf, Gll^Fmf, Gd^Vhr, Gs, Gs, Gs^Fmf, Gll^Fmf, Gll^Fmf, Gll^Fmf, Gll^Fmf, Gll^Fmf, Gs, Gll^Fmf, Gs^Fmf, Gll^Fmf, Gs, Gs^Fmf, Gs^Fmf, Gs, Gll^Fmf, Ss, Gll^Fmf, Gg, Gg, Gs, Gg, Ss, Ss, Ss, Ss, Ss^Bw|, Ss, Ss, Gs, Ss, Ss, Ss, Xu, Xu, Xu, Ur, Ur, Qxu, Qxu, Qxu, Qxu
Re, Re, Re, Re, Re, Rr, Gs, Rr, Gs, Rr, Rr, Ch, Re, Re, Re, Re, Gll^Fmf, Ww^Vm, Ww, Wo, Ww, Gg, Gll^Fmf, Gll^Fmf, Gg^Fmf, Gs, Gll^Fmf, Gll^Fmf, Gll^Fmf, Ss, Gll^Fmf, Ss, Gll^Fmf, Gs^Fmf, Ss, Gll^Fmf, Ss, Gg^Fmf, Gg^Fmf, Gg, Gg^Fmf, Gs, Gg^Fmf, Ss, Ss, Gg, Gg, Ss, Ss, Ss, Ss, Gs, Ss, Gs, Ss^Bw|, Ss, Ss, Ss, Ss, Ss, Xu, Xu, Xu, Qxu, Qxu, Ur, Ur, Qxu, Qxu, Qxu
Re, Re, Gs, Re, Gd^Vhr, Gs, Gs, Gs, Gs, Gs, Gs, Re, Gll^Fmf, Gs, Gll^Fmf, Gll^Fmf, Ww, Ww, Ww, Ww, Ww, Ww, Gll^Fmf, Gg^Fmf, Gg^Fmf, Gll^Fmf, Gs^Fmf, Gll^Fmf, Gs, Gll^Fmf, Gll^Fmf, Ss, Gg^Fmf, Gg, Gs, Ss, Gg^Fmf, Gs, Ss, Ss, Ss, Gg^Fmf, Gll^Fmf, Ss, Ss, Gg, Ss, Ss, Ss, Ss, Ss, Ss, Ss, Ss, Ss^Bw|, Ss, Ss, Gs, Ss, Xu, Xu, Xu, Xu, Qxu, Qxu, Qxu, Ur, Ur, Qxu, Qxu
Gs, Gs, Gs, Gs, Gs, Gs, Gs, Gs, Rb^Gvs, Gs, Rb^Gvs, Gs, Gs, Gg, Gs, Gll^Fmf, Ww, Ww, Wo, Ww, Ww^Vm, Gg, Gg, Gll^Fmf, Gll^Fmf, Gll^Fmf, Gs^Fmf, Gll^Fmf, Ss, Ss, Gg^Fmf, Gg^Fmf, Ss, Gg^Fmf, Ss, Gg^Fmf, Gll^Fmf, Gg^Fmf, Gll^Fmf, Gg^Fmf, Gll^Fmf, Ss, Ss, Ss, Ss, Ss, Ss^Vhs, Ss, Ss, Ss^Vhs, Ss^Bw\, Ss^Vhs, Ss^Bw/, Ss^Bw/, Ss^Vhs, Ss, Ss, Ss, Ss, Xu, Xu, Qxu, Qxu, Ur, Cud, Ur, Cud, Ur, Qxu, Qxu
Gs, Gs, Gs, Gs, Rb^Gvs, Rb^Gvs, Rb^Gvs, Rb^Gvs, Rb^Gvs, Rb^Gvs, Rb^Gvs, Rb^Gvs, Rb^Gvs, Rb^Gvs, Rb^Gvs, Gg, Gg, Ww, Ww, Ww, Gll^Fmf, Gg, Gg, Gll^Fmf, Gll^Fmf, Gs, Ss, Ss, Ss, Ss, Ss, Ss, Gg^Fmf, Ss, Ss, Ss, Ss, Ss, Ss, Gll^Fmf, Ss, Ss, Ss, Gs, Ss, Ss, Ss, Ss, Ss, Gs, Gs, Gs, Ss, Ss^Bw|, Ss, Ss, Ss, Ss, Ss, Xu, Xu, Qxu, Qxu, Cud, Cud, 3 Kud, Cud, Cud, Qxu, Qxu
Gs, Gs, Rb^Gvs, Rb^Gvs, Rb^Gvs, Rb^Gvs, Rb^Gvs, Rb^Gvs, Rb^Gvs, Rb^Gvs, Rb^Gvs, Rb^Gvs, Rb^Gvs, Rb^Gvs, Gg, Gg, Ww, Ww, Wo, Ww, Gll^Fmf, Gll^Fmf, Gg^Fmf, Gll^Fmf, Gll^Fmf, Gll^Fmf, Ss, Ss, Gg^Fmf, Gg^Fmf, Ss, Gg^Fmf, Ss, Ss, Ss, Ss, Ss^Vhs, Ss, Ss, Ss, Ss, Gs, Gs, Gs, Ss, Ss, Ss, Ss, Ss^Vhs, Ss^Bw/, Ss, Ss^Bw\, Ss^Bw\, Ss^Vhs, Ss, Ss, Ss, Ss, Ss, Ss, Xu, Xu, Cud, Ur, Ur, Ur, Ur, Ur, Cud, Qxu
Rb^Gvs, Rb^Gvs, Rb^Gvs, Rb^Gvs, Rb^Gvs, Rb^Gvs, Rb^Gvs, Rb^Gvs, Rb^Gvs, Gd^Vhr, Rb^Gvs, Rb^Gvs, Rb^Gvs, Rb^Gvs, Gll^Fmf, Ww, Ww, Wo, Ww, Ww, Gll^Fmf, Gll^Fmf, Gll^Fmf, Gll^Fmf, Gll^Fmf, Gll^Fmf, Gll^Fmf, Gll^Fmf, Gg^Fmf, Gll^Fmf, Ss, Ss, Ss, Ss, Ss, Ss, Ss, Ss, Ss, Ss, Ss, Gs, Ss, Ss, Ss, Ss, Ss, Ss, Ss, Ss, Ss, Ss, Ss, Ss^Vhs, Ss, Ss, Ss, Ss, Ss, Ss, Xu, Xu, Xu, Cud, Cud, Ur, Cud, Ur, Ur, Xu
Rb^Gvs, Rb^Gvs, Gs, Rb^Gvs, Rb^Gvs, Rb^Gvs, Rb^Gvs, Rb^Gvs, Rb^Gvs, Rb^Gvs, Rb^Gvs, Rb^Gvs, Rb^Gvs, Gs, Gs, Ww, Ww, Wo, Ww, Gll^Fmf, Gll^Fmf, Gg^Fmf, Gll^Fmf, Gll^Fmf, Gll^Fmf, Gll^Fmf, Gll^Fmf, Gll^Fmf, Gll^Fmf, Ss, Ss, Ss, Ss, Ss, Ss, Ss, Ss, Ss, Ss, Ss, Ss, Ss, Ss, Ss, Ss, Ss, Ss, Ss, Ss, Ss, Ss, Ss, Ss, Ss, Ss, Ss, Ss, Ss, Ss, Ss, Ss, Xu, Xu, Xu, Xu, Xu, Xu, Xu, Xu, Xu
