border_size=1
usage=map

Mm^Xm, Mm^Xm, Mm^Xm, Mm^Xm, Mm^Xm, Mm^Xm, Mm^Xm, Mm, Hh, Hh, Hh, Hh, Hh, Mm, Mm, Mm, Mm, Mm, Mm, Mm, Hh, Mm, Mm, Mm, Mm, Mm, Mm, Mm^Xm, Mm, Mm, Hhd^Fdw, Mm, Mm, Mm, Mm, Mm, Mm, Mm, Wwg, Mm, Mm, Mm^Xm, Mm^Xm, Mm^Xm
Mm^Xm, Mm^Xm, Mm^Xm, Mm^Xm, Mm^Xm, Mm^Xm, Mm, Mm, Mm, Hh, Hh, Hh, Hh, Mm, Mm, Mm, Mm, Mm, Mm, Mm, Ss, Mm, Ww, Mm, Mm, Mm, Mm, Mm, Hhd^Fdw, Hhd^Fdw, Hhd^Fdw, Hhd^Fdw, Mm, Mm, Mm, Mm, Mm, Ss, Ss, Ss^Uf, Mm, Mm, Mm, Mm^Xm
Mm^Xm, Mm^Xm, Mm^Xm, Mm^Xm, Mm, Mm, Mm, Mm, Wwf, Hhd^Fdw, Ss, Hhd^Fdw, Hh, Hh, Mm, Mm, Mm, Mm, Mm, Ss, Mm, Ss, Ss, Ss, Ss, Mm, Mm, Mm, Mm, Mm, Mm, Mm, Mm, Mm, Hh, Hh, Hh, Ss, Mm, Mm, Mm, Mm, Mm, Mm
Mm^Xm, Mm^Xm, Mm^Xm, Mm^Xm, Ss, Mm, Mm, Hhd^Fdw, Ss, Ss, Wwg, Ss, Ss, Mm, Mm, Mm, Hhd^Fdw, Mm, Mm, Mm, Mm, Mm, Ss, Ww, Ss, Mm, Hh, Mm, Hh, Mm, Hh, Mm, Hh, Hh, Hhd^Fdw, Hhd^Fdw, Hhd^Fdw, Re, Wwf, Mm, Mm, Mm, Mm, Mm
Mm^Xm, Mm^Xm, Ww, Ss, Ss, Mm, Mm, Hhd^Fdw, Mm, Wwf, Ss, Ss, Mm, Ss, Ss, Hhd^Fdw, Hh, Ss^Uf, Mm, Mm, Mm^Fdw, Mm, Hhd^Fdw, Mm, Hhd^Fdw, Re, Hhd^Fdw, Hh, Hh, Hh, Hh, Hhd^Fdw, Hh, Hhd^Fdw, Gll^Fdw, Gll^Fdw, Gll^Fdw, Hhd^Fdw, Ss, Hh, Hh, Hhd^Fdw, Hhd^Fdw, Hh
Mm^Xm, Mm, Ww, Ww, Ww, Ss, Mm^Fdw, Mm, Mm, Mm, Hh, Hh, Mm, Mm, Wwf, Hh, Wwf, Hh, Hh, Hh, Hhd^Fdw, Hhd^Fdw, Hhd^Fdw, Hh, Hh, Wwf, Ss, Hhd^Fdw, Hhd^Fdw, Hh, Hh, Hh, Hhd^Fdw, Hhd^Fdw, Gll^Fdw, Gll^Fdw, Gll^Fdw, Gll^Fdw, Ss, Hh^Uf, Hh, Hhd^Fdw, Hh, Hh
Mm, Mm, Ss, Ww, Mm^Uf, Ww, Wwf, Mm, Mm, Mm, Hh, Hh, Hh, Hh, Hh, Wwf, Hh, Ss, Gs^Vht, Hh, Hh, Hh, Hh, Hh, Hh, Hhd^Fdw, Hhd^Fdw, Re, Gll^Fdw, Hh, Gll^Fdw, Hh, Gll^Fdw, Gll^Fdw, Ss, Gll^Fdw, Gll^Fdw, Gll^Fdw, Ss, Ss, Gll^Fdw, Hh, Hh, Hh
Mm^Xm, Mm, Mm, Mm, Mm, Mm, Wwf, Hh, Hh, Hh, Hh, Hhd^Fdw, Hhd^Fdw, Hh, Hh, Hh, Hh, Ss, Wwf, Hh, Hh, Hh, Hh, Hh, Hh, Hh, Ss, Ss, Gll^Fdw, Gll^Fdw, Ss^Vhs, Ss, Gs, Ss, Gll^Fdw, Gll^Fdw, Gs, Gs, Re^Vct, Ss, Gs, Gs^Vht, Rd, Hh
Mm^Xm, Mm, Mm, Mm, Mm, Hh^Vhh, Hh, Wwf, Ss, Hh, Hh, Hhd^Fdw, Hhd^Fdw, Hhd^Fdw, Hhd^Fdw, Hh, Hhd^Fdw, Hh, Hhd^Fdw, Wwf, Gs, Hh, Gs, Hh, Ss, Hh^Fdw, Gll^Fdw, Ss, Ss, Gs, Gs, Ss, Gs, Gs, Gs, Gs, Re^Vct, Gs, Gs, Gs, Rd, Rd, Gs, Rd
Mm, Mm, Mm, Mm, Hh, Hh, Hh, Hh, Hh, Wwf, Hh, Hh, Hhd^Fdw, Gll^Fdw, Gll^Fdw, Gll^Fdw, Gll^Fdw, Gll^Fdw, Wwf, Wwf, Gs, Gll^Fdw, Gll^Fdw, Gll^Fdw, Gll^Fdw, Gs, Gs, Ss, Gs, Wwf, Wwg, Gs, Gs, Gs, Gs, Gs, Gs, Gs, Ce, Ce, Ce, Gs, Ds, Gs
Mm, Mm, Hh, Hh, Hh, Hhd^Fdw, Gll^Fdw, Hhd^Fdw, Gll^Fdw, Wwf, Ss, Gll^Fdw, Gs, Gll^Fdw, Gs, Hh^Fdw, Gll^Fdw, Gs, Wwf, Gll^Fdw, Gs, Gs, Gs, Gll^Fdw, Ss, Ss, Gs^Vh, Gs, Gs, Gs, Gs, Ss, Wwf, Ss, Wwf, Gs, Rd, Rd, Ce, 1 Ke, Ce, Gs, Ww^Vm, Ww
Hh, Hh, Hh, Hh, Hh, Hhd^Fdw, Hhd^Fdw, Gs, Gs, Gs, Gs, Wwf, Wwf, Gs, Hh, Hh, Hh^Vhh, Gs, Ss, Gs, Gs, Gll^Fdw, Gll^Fdw, Gll^Fdw, Wwf, Ss, Wwf, Gs, Rd, Rd, Rd, Rd, Rd, Rd, Rd, Wwf, Gs, Gs, Rd, Ce, Ww, Ss, Ww, Ww
Hh, Hh, Hh, Hh, Hh, Hhd^Fdw, Hhd^Fdw, Gs, Gs, Gll^Fdw, Gs, Gs, Ss, Gs, Hh, Hh^Fdw, Mm, Hh, Rd, Wwf, Wwg, Rd, Rd, Rd, Rd, Wwf^Bw/, Ss^Bw\r, Ss^Bw/, Ss, Ss, Gll^Fdw, Gll^Fdw, Gll^Fdw, Gs, Gs, Wwg, Wwg, Gs, Rd, Gs, Ww, Ww, Wwt, Wwt
Hh, Hh, Hh, Hh, Hh, Ss, Ss, Gll^Fdw, Gll^Fdw, Gs^Vc, Gll^Fdw, Gll^Fdw, Gs, Ss, Wwf, Hh, Rd, Rd, Ss, Rd, Wwg, Gll^Fdw, Gs, Gs, Gll^Fdw, Gll^Fdw, Gll^Fdw, Ss, Ww, Wwf, Gll^Fdw, Gll^Fdw, Gll^Fdw, Gs, Ss, Ss, Wwg, Wwg, Ww^Bw|, Ww, Wwt, Wwt, Wwt, Wwt
Hh, Hh, Hh, Hh, Hh, Ss, Hh, Ss, Gs, Gs, Mm, Gs, Gll^Fdw, Gs, Rd, Wwf, Ss, Gs, Wwf, Ss, Wwg, Wwf, Gs, Gs, Gs, Gll^Fdw, Gs, Gs^Vht, Gs, Gs, Re, Re, Gs, Gs, Ss, Ww, Wwt, Wwt, Wwt^Bw|, Wwt, Ww, Wwt, Ww, Wwt
Rd, Hh, Gs, Hh, Hh, Hh, Hh, Ss, Ss, Hh^Fdw, Mm, Mm, Rd, Rd, Gs, Gs^Vht, Gs, Gs, Ss, Wwf, Gll^Fdw, Wwg, Wwg, Gs, Ww, Gs, Re, Gs, Ww, Ww, Ww, Wwg, Ww, Ww, Ww, Ww, Wwt, Wwt, Ww^Bw|, Ww, Gs, Ww, Ww, Ww
Gs, Rd, Rd, Ss, Rd, Hh, Rd, Hh, Rd, Gs, Rd, Rd, Gs, Gll^Fdw, Gll^Fdw, Gll^Fdw, Gs, Gs, Ww, Ww, Ww, Ww, Ww, Ww, Ww, Ww, Ww, Ww, Wwt, Wwt, Ww, Ww, Ww, Wwt, Wwt, Wwt, Ss, Ww, Rd, Re, Gs, Gs, Gs, Ds
Ss, Gs, Ss, Rd, Gs, Rd, Wwf, Rd, Gs, Rd, Gs, Gs, Gs, Gll^Fdw, Wwg, Re, Ww, Ww, Ww, Ww, Ww, Wwt, Wwt, Ww, Re, Ww, Ww, Ww, Wwg, Ww, Gll^Fdw, Ww, Re, Ww, Ww, Ww, Rd, Rd, Gll^Fdw, Gll^Fdw, Gll^Fdw, Gll^Fdw, Gll^Fdw, Gll^Fdw
Hh, Hh, Hh, Wwf, Wwf, Wwf, Wwf, Ss, Ss, Wwf, Wwg, Ss, Wwf, Wwf, Wwg, Wwg, Ww, Ww, Ww, Ww, Ww, Ww, Ww, Ww, Wwg, Ww, Ss, Ss, Gs, Gll^Fdw, Gll^Fdw, Gs, Wwf, Ww, Gs, Hh, Rd, Gll^Fdw, Gll^Fdw, Gll^Fdw, Gll^Fdw, Gll^Fdw, Gll^Fdw, Ss
Hh, Hh, Hh, Ss, Ce, Wwf, Hh, Hh^Vo, Re, Wwg, Wwf, Wwg, Wwg, Wwg, Ww, Ww, Ww, Ww, Ss, Gs, Gs, Wwg, Wwf, Hh, Gs, Gs, Gs, Gs, Gs, Gll^Fdw, Ww, Wwf, Gll^Fdw, Gs, Gll^Fdw, Gs, Rd, Gll^Fdw, Gll^Fdw, Gll^Fdw, Gll^Fdw, Gll^Fdw, Gll^Fdw, Gll^Fdw
Ss, Ss, Gs, Ce, 2 Ket, Ce, Rd, Rd, Ww, Gs, Ww, Ww, Ww, Ww, Wwt, Ww, Ww, Ss, Gs^Vht, Gs, Ss, Wwg, Gs, Gs, Gll^Fdw, Gs, Gll^Fdw, Gs, Ss, Gs, Ww, Hhd^Fdw, Gll^Fdw, Gll^Fdw, Rd, Rd, Gll^Fdw, Gs^Vht, Gs, Gll^Fdw, Gll^Fdw, Gll^Fdw, Gll^Fdw, Gll^Fdw
Ss, Ss, Gs, Ce, Ce, Ce, Ww, Ww, Ww, Ww, Ww, Ww, Wwt, Wwt, Ww, Ww, Ww, Gll^Fdw, Gs, Gs, Wwg, Wwf, Gs, Gll^Fdw, Hhd^Fdw, Gll^Fdw, Gs, Ss, Ss, Gs, Ww, Ww, Ww, Ww, Ww, Ww, Ww, Gs, Ww, Gll^Fdw, Ww, Gll^Fdw, Gll^Fdw, Gll^Fdw
Ww, Ww, Ww, Ww, Wwf, Wwf, Ww, Ww, Ww, Ww, Ww, Ww, Ww, Ww, Ww, Ww, Gll^Fdw, Gs, Gs, Ss, Ss, Ss, Gll^Fdw, Gll^Fdw, Hhd^Fdw, Hhd^Fdw, Ss, Ss, Ww, Ww, Ww, Ww, Ww, Ww, Ww, Ww, Ww, Ww, Ww, Ww, Ww, Wwf, Gll^Fdw, Gll^Fdw
Ww, Ww, Ww, Ww, Wwf, Ww, Ss, Ww, Hh, Ww, Wwf, Ww, Ww, Ww, Ww, Hh, Hh, Hhd^Fdw, Wwf, Ss, Wwg, Ss, Gll^Fdw, Gll^Fdw, Gs, Gll^Fdw, Ss, Wwf, Ww, Ww, Wwt, Wwt, Wwt, Wwt, Wwt, Wwt, Wwt, Wwt, Wwt, Ww, Ww, Gll^Fdw, Gs, Gs
Ww, Ww, Gs, Gs, Gs, Wwf, Gs, Hh, Hh, Ss, Gs, Gs, Hh, Gs, Hh, Hh, Ss, Wwf, Ss, Wwf, Wwg, Ss, Ss, Gs, Gs, Ss, Ss, Ww, Ww, Ww, Wwt, Wwt, Wwt, Wwt, Wwt, Wwt, Wwt, Wwt, Wwt, Ww, Ww, Gs, Gs, Gs
Hh, Gs, Gs, Gs, Gs, Gs, Gs, Gs, Gs, Gs, Ss, Gs, Hh, Hh, Hh, Hh, Hh, Hhd^Fdw, Hhd^Fdw, Ss, Hh, Hhd^Fdw, Gs, Gs, Gs, Gs, Ww, Ww, Ww, Ww, Wwt, Wwt, Wwt, Wwt, Wwt, Wwt, Wwt, Wwt, Wwt, Wwt, Ww, Ww, Hh, Gs
Hh, Hh, Hh, Hh, Hh, Hh, Hh, Gs, Hh, Ss, Hh, Hh, Hhd^Fdw, Hhd^Fdw, Gs, Hh, Hh, Hh, Gs, Hh, Hh, Hh, Hh, Gs, Gs, Gs, Gs, Ww, Hh, Wwt, Wwt, Wwt, Wwt, Wwt, Wwt, Wwt, Wwt, Wwt, Ww, Ww, Ww, Ww, Hhd^Fdw, Gs
Hh, Hh, Hh, Hh, Mm, Hh, Hh, Hh, Mm, Hh, Hh, Hh, Hh, Hh, Gs, Gs, Hh, Gs, Gs, Gs, Hh, Hh, Hh, Gs, Gs, Hh, Gs, Wwf, Ww, Ww, Ww, Wwt, Ww, Ww, Ww, Ww, Ww, Ww, Ss, Ww, Ss, Hhd^Fdw, Gll^Fdw, Gll^Fdw
Mm, Hh, Mm, Mm, Ss, Ss, Wwg, Wwf, Mm, Hh, Mm, Hh, Hh, Hh, Hh, Hh, Hh, Hh, Hh, Mm, Mm, Hh, Hh, Hh, Hh, Hh, Gll^Fdw, Gs, Gs, Ww, Ww, Ww, Wwf, Ww, Ww, Ww, Ww, Ww, Ss, Ss, Gll^Fdw, Hhd^Fdw, Gll^Fdw, Gll^Fdw
Mm, Mm, Mm, Mm, Ss, Wwg, Ss, Ss, Mm, Mm, Mm, Mm, Mm, Hh, Mm, Hh, Hh, Hh, Hh, Mm, Hh, Hh^Vhh, Hh, Hh, Hhd^Fdw, Gll^Fdw, Hh, Hhd^Fdw, Gll^Fdw, Hh, Hh, Wwf, Hh, Hhd^Fdw, Gll^Fdw, Ww^Vm, Gs, Ss, Ss, Ss, Ss, Gll^Fdw, Gll^Fdw, Gll^Fdw
Mm, Mm, Mm, Mm, Mm, Mm, Mm, Mm^Fdw, Mm, Mm, Mm, Mm, Mm, Hh, Mm, Mm, Mm, Hh, Hh, Hh, Gs, Hh, Hh, Hh, Hh, Hhd^Fdw, Hhd^Fdw, Hhd^Fdw, Hhd^Fdw, Hhd^Fdw, Hh, Gs, Gs, Gs, Gll^Fdw, Gll^Fdw, Gll^Fdw, Gll^Fdw, Gll^Fdw, Gll^Fdw, Gll^Fdw, Gll^Fdw, Gll^Fdw, Gll^Fdw
Mm, Mm, Mm, Mm, Mm, Mm, Mm, Mm, Mm, Mm, Mm, Mm, Gs, Mm, Mm, Mm, Mm, Mm, Hh, Hh, Hh, Hh, Hh, Hh, Hh, Hh, Hh, Hh, Hh, Hhd^Fdw, Hh, Gs, Hh, Hh, Gs, Gll^Fdw, Gs, Gll^Fdw, Gs, Gll^Fdw, Gs, Gll^Fdw, Gll^Fdw, Gll^Fdw
